Reference	Localized Group	Message	Selections	
figs-123person_6_4__1	First, Second or Third Person	unable to migrate selection, no match found for check in new resources	प्रत्येकले उसको आफ्नो कामको जाँच गरोस् र त्यसपछि उसँग अरू कसैमा होइन बरू आफैमा मात्र गर्व गर्ने केही कारण हुनेछ।-1	
figs-123person_6_6__1	First, Second or Third Person	unable to migrate selection, no match found for check in new resources	सबै असल कुराहरूमा वचन सिकाइएको व्यक्तिले एकै शिक्षाद्धारा बाँडोस् ।-1	
figs-abstractnouns_1_12__1	Abstract Nouns	unable to migrate selection, no match found for check in new resources	येशू ख्रीष्टको प्रकाश-1	
figs-abstractnouns_2_13__1	Abstract Nouns	unable to migrate selection, no match found for check in new resources	तिनीहरूको कपटले-1	
figs-abstractnouns_2_14__1	Abstract Nouns	unable to migrate selection, no match found for check in new resources	सुसमाचारको सत्यता-1	
figs-abstractnouns_2_16__-1	Abstract Nouns	unable to migrate selection, no match found for check in new resources	व्यवस्थाका कामहरू-1	
figs-abstractnouns_2_16__-1	Abstract Nouns	unable to migrate selection, no match found for check in new resources	विश्वास-1 विश्वास-3	
figs-abstractnouns_2_17__1	Abstract Nouns	unable to migrate selection, no match found for check in new resources	पापी ठहरियौं-1 पापको-1	
figs-abstractnouns_2_18__1	Abstract Nouns	unable to migrate selection, no match found for check in new resources	अपराधी-1	
figs-abstractnouns_2_20__1	Abstract Nouns	unable to migrate selection, no match found for check in new resources	विश्‍वास-1	
figs-abstractnouns_2_21__1	Abstract Nouns	unable to migrate selection, no match found for check in new resources	परमेश्‍वरको अनुग्रह-1	
figs-abstractnouns_2_21__1	Abstract Nouns	unable to migrate selection, no match found for check in new resources	धार्मिकता-1	
figs-abstractnouns_2_2__1	Abstract Nouns	unable to migrate selection, no match found for check in new resources	प्रकाश अनुसार-1	
figs-abstractnouns_2_4__1	Abstract Nouns	unable to migrate selection, no match found for check in new resources	ख्रीष्ट येशूमा भएको हाम्रो स्वतन्त्रताको जासुसी गर्न-1	
figs-abstractnouns_2_5__1	Abstract Nouns	unable to migrate selection, no match found for check in new resources	हामी-1 समर्पित भए-1	
figs-abstractnouns_2_5__1	Abstract Nouns	unable to migrate selection, no match found for check in new resources	सुसमाचारको सत्यता-1	
figs-abstractnouns_2_9__1	Abstract Nouns	unable to migrate selection, no match found for check in new resources	मलाई दिइएको अनुग्रह बुझेर-1	
figs-abstractnouns_2_9__1	Abstract Nouns	unable to migrate selection, no match found for check in new resources	सङ्गतिको-1	
figs-abstractnouns_3_10__1	Abstract Nouns	unable to migrate selection, no match found for check in new resources	श्रापित हुन्‍छन्-1	
figs-abstractnouns_3_11__1	Abstract Nouns	unable to migrate selection, no match found for check in new resources	विश्वासद्वारा-1	
figs-abstractnouns_3_12__1	Abstract Nouns	unable to migrate selection, no match found for check in new resources	विश्‍वासबाट-1	
figs-abstractnouns_3_13__1	Abstract Nouns	unable to migrate selection, no match found for check in new resources	व्यवस्थाको श्रापबाट-1 श्रापित-2	
figs-abstractnouns_3_14__1	Abstract Nouns	unable to migrate selection, no match found for check in new resources	आशिष्-1	
figs-abstractnouns_3_14__1	Abstract Nouns	unable to migrate selection, no match found for check in new resources	विश्वास-1	
figs-abstractnouns_3_14__1	Abstract Nouns	unable to migrate selection, no match found for check in new resources	पवित्र आत्माको प्रतिज्ञा-1	
figs-abstractnouns_3_19__1	Abstract Nouns	unable to migrate selection, no match found for check in new resources	अपराध-1	
figs-abstractnouns_3_22__1	Abstract Nouns	unable to migrate selection, no match found for check in new resources	विश्‍वास-1	
figs-abstractnouns_3_23__1	Abstract Nouns	unable to migrate selection, no match found for check in new resources	विश्‍वास-1 विश्‍वासको प्रकाश-1 आउन्जेल-1	
figs-abstractnouns_3_24__1	Abstract Nouns	unable to migrate selection, no match found for check in new resources	विश्‍वास-1	
figs-abstractnouns_3_25__1	Abstract Nouns	unable to migrate selection, no match found for check in new resources	विश्‍वास-1	
figs-abstractnouns_3_26__1	Abstract Nouns	unable to migrate selection, no match found for check in new resources	विश्‍वास-1	
figs-abstractnouns_3_2__1	Abstract Nouns	unable to migrate selection, no match found for check in new resources	विश्‍वास-1	
figs-abstractnouns_3_6__1	Abstract Nouns	unable to migrate selection, no match found for check in new resources	धार्मिकता-1	
figs-abstractnouns_3_8__1	Abstract Nouns	unable to migrate selection, no match found for check in new resources	विश्‍वासद्वारा-1	
figs-abstractnouns_4_13__1	Abstract Nouns	unable to migrate selection, no match found for check in new resources	शारीरिक कमजोरी-1	
figs-abstractnouns_4_14__1	Abstract Nouns	unable to migrate selection, no match found for check in new resources	परीक्षा-1	
figs-abstractnouns_4_15__1	Abstract Nouns	unable to migrate selection, no match found for check in new resources	आशिष्-1 छ-1	
figs-abstractnouns_4_16__1	Abstract Nouns	unable to migrate selection, no match found for check in new resources	तिमीहरूसँग सत्‍य बताएर-1	
figs-abstractnouns_4_24__1	Abstract Nouns	unable to migrate selection, no match found for check in new resources	दासत्व-1	
figs-abstractnouns_4_25__1	Abstract Nouns	unable to migrate selection, no match found for check in new resources	तिनी-1 दासत्वमा छिन्-1	
figs-abstractnouns_5_10__1	Abstract Nouns	unable to migrate selection, no match found for check in new resources	न्याय पाउनेछ-1	
figs-abstractnouns_5_11__1	Abstract Nouns	unable to migrate selection, no match found for check in new resources	खतना-1	
figs-abstractnouns_5_13__1	Abstract Nouns	unable to migrate selection, no match found for check in new resources	स्वतन्‍त्रता-1 स्वतन्त्र-1	
figs-abstractnouns_5_13__1	Abstract Nouns	unable to migrate selection, no match found for check in new resources	प्रेम-1	
figs-abstractnouns_5_16__1	Abstract Nouns	unable to migrate selection, no match found for check in new resources	शरीरका अभिलाषाहरू-1	
figs-abstractnouns_5_19__1	Abstract Nouns	unable to migrate selection, no match found for check in new resources	शरीरका कामहरू-1 यौन अनैतिकता, अपवित्रता, कामवासना,-1	
figs-abstractnouns_5_1__1	Abstract Nouns	unable to migrate selection, no match found for check in new resources	स्वतन्‍त्रताको निम्ति-1 दासत्वको-1	
figs-abstractnouns_5_21__1	Abstract Nouns	unable to migrate selection, no match found for check in new resources	डाह, पियक्‍कडपन, मोजमज्‍जा-1	
figs-abstractnouns_5_22__1	Abstract Nouns	unable to migrate selection, no match found for check in new resources	प्रेम, आनन्‍द, शान्‍ति, धैर्य, दया, भलाइ, विश्‍वासयोग्यता,-1	
figs-abstractnouns_5_23__1	Abstract Nouns	unable to migrate selection, no match found for check in new resources	नम्रता र संयम हुन्-1	
figs-abstractnouns_5_24__1	Abstract Nouns	unable to migrate selection, no match found for check in new resources	लालसा र दुष्‍ट अभिलाषाहरू-1	
figs-abstractnouns_5_5__1	Abstract Nouns	unable to migrate selection, no match found for check in new resources	विश्वासद्वारा-1 धार्मिकताको आशाको-1	
figs-abstractnouns_5_6__1	Abstract Nouns	unable to migrate selection, no match found for check in new resources	खतना-1 बेखतना-1 प्रेम-1 विश्‍वास-1	
figs-abstractnouns_5_7__1	Abstract Nouns	unable to migrate selection, no match found for check in new resources	सत्‍यताद्धारा-1	
figs-abstractnouns_6_16__1	Abstract Nouns	unable to migrate selection, no match found for check in new resources	तिनीहरूमा र परमेश्‍वरको इस्राएलमा शान्‍ति र कृपा रहन्छ।-1	
figs-abstractnouns_6_17__1	Abstract Nouns	unable to migrate selection, no match found for check in new resources	मलाई कसैले दुःख नदेओस्-1	
figs-abstractnouns_6_18__1	Abstract Nouns	unable to migrate selection, no match found for check in new resources	अनुग्रह-1	
figs-abstractnouns_6_1__1	Abstract Nouns	unable to migrate selection, no match found for check in new resources	अपराध-1	
figs-abstractnouns_6_2__1	Abstract Nouns	unable to migrate selection, no match found for check in new resources	एक अर्काको भार-1	
figs-abstractnouns_6_4__1	Abstract Nouns	unable to migrate selection, no match found for check in new resources	आफ्नो कामको-1 उसँग-1 गर्व गर्ने केही कारण हुनेछ-1	
figs-abstractnouns_6_5__1	Abstract Nouns	unable to migrate selection, no match found for check in new resources	आफ्नो भार-1	
figs-abstractnouns_6_8__1	Abstract Nouns	unable to migrate selection, no match found for check in new resources	विनाशको कटनी गर्नेछ-1	
figs-activepassive_2_13__1	Active or Passive	unable to migrate selection, no match found for check in new resources	बारनाबास पनि तिनीहरूको कपटले भड्किए ।-1	
figs-activepassive_2_16__1	Active or Passive	unable to migrate selection, no match found for check in new resources	कोही मानिस पनि-1 धर्मी ठहरिँदैन-1 हामी-2 धर्मी ठहरिन सकौं-1 धर्मी ठहरिने-1	
figs-activepassive_2_17__1	Active or Passive	unable to migrate selection, no match found for check in new resources	ख्रीष्टमा धर्मी ठहरिन-1	
figs-activepassive_2_17__1	Active or Passive	unable to migrate selection, no match found for check in new resources	हामी आफैं पनि पापी ठहरियौं भने-1	
figs-activepassive_2_19__1	Active or Passive	unable to migrate selection, no match found for check in new resources	म ख्रीष्टसँग क्रूसमा टाँगिएको छु-1	
figs-activepassive_2_7__1	Active or Passive	unable to migrate selection, no match found for check in new resources	मलाई-1 सुम्पिएको-1	
figs-activepassive_2_9__1	Active or Passive	unable to migrate selection, no match found for check in new resources	दिइएको-1	
figs-activepassive_3_10__1	Active or Passive	unable to migrate selection, no match found for check in new resources	यसरी लेखिएको छ-1 लेखिएका-1	
figs-activepassive_3_11__1	Active or Passive	unable to migrate selection, no match found for check in new resources	व्यवस्थाद्वारा परमेश्वरको सामु कोही पनि धर्मी नठहरिने-1	
figs-activepassive_3_15__1	Active or Passive	unable to migrate selection, no match found for check in new resources	मानिसले स्थापना गरेको-1	
figs-activepassive_3_17__1	Active or Passive	unable to migrate selection, no match found for check in new resources	परमेश्‍वरले पहिले नै स्थापना गर्नुभएको-1	
figs-activepassive_3_19__1	Active or Passive	unable to migrate selection, no match found for check in new resources	प्रतिज्ञा गरिएका-1	
figs-activepassive_3_1__1	Active or Passive	unable to migrate selection, no match found for check in new resources	समा टाँगिनुभएको कुरा दर्शाइएको थियो-1	
figs-activepassive_3_21__1	Active or Passive	unable to migrate selection, no match found for check in new resources	व्यवस्था दिइएको-1	
figs-activepassive_3_22__1	Active or Passive	unable to migrate selection, no match found for check in new resources	येशू ख्रीष्‍टमा विश्‍वासद्वारा प्रतिज्ञा विश्‍वास गर्नेहरूलाई दिन सकियोस्-1	
figs-activepassive_3_23__1	Active or Passive	unable to migrate selection, no match found for check in new resources	हामी व्यवस्थामुनि बन्दी बनाइयौ-1	
figs-activepassive_3_23__1	Active or Passive	unable to migrate selection, no match found for check in new resources	कैदमा थियौँ-1	
figs-activepassive_3_27__1	Active or Passive	unable to migrate selection, no match found for check in new resources	बप्‍तिस्मा भयो-1	
figs-activepassive_3_6__1	Active or Passive	unable to migrate selection, no match found for check in new resources	गनियो-1	
figs-activepassive_3_8__1	Active or Passive	unable to migrate selection, no match found for check in new resources	तँबाट सबै जातिहरू आशिषित हुनेछन्-1	
figs-activepassive_3_9__1	Active or Passive	unable to migrate selection, no match found for check in new resources	विश्वासद्धारा तिनीहरू-1 आशिषित हुन्‍छन्-1	
figs-activepassive_4_19__1	Active or Passive	unable to migrate selection, no match found for check in new resources	ख्रीष्‍ट नबनिनुभएसम्म-1	
figs-activepassive_4_22__1	Active or Passive	unable to migrate selection, no match found for check in new resources	लेखिएको छ-1	
figs-activepassive_4_24__1	Active or Passive	unable to migrate selection, no match found for check in new resources	यी कुराहरूलाई एउटा रूपक दृष्‍टान्‍त झै वर्णन गरिन्छ,-1	
figs-activepassive_4_27__1	Active or Passive	unable to migrate selection, no match found for check in new resources	यस्तो लेखिएको छ-1	
figs-activepassive_4_2__1	Active or Passive	unable to migrate selection, no match found for check in new resources	उसको बुबाले निर्धारण गरेको समय-1	
figs-activepassive_4_3__1	Active or Passive	unable to migrate selection, no match found for check in new resources	यस जगत्‌का आधारभूत सिद्धान्‍तहरूको बन्धनमा थियौँ ।-1	
figs-activepassive_4_5__1	Active or Passive	unable to migrate selection, no match found for check in new resources	हामी धर्मपुत्रको रूपमा स्वीकारिऔँ।-1	
figs-activepassive_4_9__1	Active or Passive	unable to migrate selection, no match found for check in new resources	तिमीहरू परमेश्‍वरद्वारा चिनिएका छौ भने-1	
figs-activepassive_5_13__1	Active or Passive	unable to migrate selection, no match found for check in new resources	तिमीहरू स्वतन्‍त्रताको निम्ति बोलाइएका छौ-1	
figs-activepassive_5_14__1	Active or Passive	unable to migrate selection, no match found for check in new resources	सारा व्यवस्था एउटै आज्ञामा पुरा भएको छ,-1	
figs-activepassive_5_15__1	Active or Passive	unable to migrate selection, no match found for check in new resources	तिमीहरू आफै एक अर्काबाट नष्‍ट हुन नपरोस्-1	
figs-activepassive_5_18__1	Active or Passive	unable to migrate selection, no match found for check in new resources	आत्माले तिमीहरूलाई अगुवाइ गर्नुहुन्‍छ-1	
figs-activepassive_5_1__1	Active or Passive	unable to migrate selection, no match found for check in new resources	फेरि-1 मुनि नपर-1	
figs-activepassive_5_25__1	Active or Passive	unable to migrate selection, no match found for check in new resources	हामी आत्माद्वारा जिउँछौँ-1	
figs-activepassive_5_2__1	Active or Passive	unable to migrate selection, no match found for check in new resources	कि तिमीहरूको खतना भए तापनि-1	
figs-activepassive_5_3__1	Active or Passive	unable to migrate selection, no match found for check in new resources	खतना गरिएका-1	
figs-activepassive_5_4__1	Active or Passive	unable to migrate selection, no match found for check in new resources	धर्मी ठहराइएका छौ, तिमीहरू-1 अलग गरिएका छौ-1	
figs-activepassive_5_7__1	Active or Passive	unable to migrate selection, no match found for check in new resources	सत्‍यताद्धारा उत्प्रेरित नहुन-1	
figs-activepassive_6_12__1	Active or Passive	unable to migrate selection, no match found for check in new resources	सतावट भोग्‍न नपरोस्।-1	
figs-activepassive_6_13__1	Active or Passive	unable to migrate selection, no match found for check in new resources	खतना भएकाहरू-1 खतना भएको-1	
figs-activepassive_6_14__1	Active or Passive	unable to migrate selection, no match found for check in new resources	म संसारको लागि र संसार मेरो लागि क्रुसमा टाँगिएको छ ।-1	
figs-activepassive_6_6__1	Active or Passive	unable to migrate selection, no match found for check in new resources	सिकाइएको व्यक्तिले-1	
figs-activepassive_6_7__1	Active or Passive	unable to migrate selection, no match found for check in new resources	धोकामा नपर । परमेश्‍वरको ठट्टा गरिएको छैन-1	
figs-distinguish_2_3__1	Distinguishing Versus Informing or Reminding	unable to migrate selection, no match found for check in new resources	मसँग भएको ती-1 सलाई पनि ग्रीक भएकोले-1 थिएन-1	
figs-doublenegatives_4_30__1	Double Negatives	unable to migrate selection, no match found for check in new resources	गर्नेछैन-1	
figs-doublenegatives_5_16__1	Double Negatives	unable to migrate selection, no match found for check in new resources	गर्नेछैनौ-1	
figs-ellipsis_2_20__1	Ellipsis	unable to migrate selection, no match found for check in new resources	जुन जीवन म-1 जिउँछु-1	
figs-ellipsis_2_2__1	Ellipsis	unable to migrate selection, no match found for check in new resources	गोप्य रूपमा-1	
figs-ellipsis_2_8__1	Ellipsis	unable to migrate selection, no match found for check in new resources	अन्यजातिहरूका निम्ति पनि काम गर्नुभयो-1	
figs-ellipsis_2_9__1	Ellipsis	unable to migrate selection, no match found for check in new resources	हामी अन्यजातिहरूलाई र उनीहरू खतना भएकाहरूका माझमा जान सकून् ।-1	
figs-ellipsis_3_16__1	Ellipsis	unable to migrate selection, no match found for check in new resources	धेरै मानिसहरूलाई झै गरी-1 तर एक जनालाई झै-1	
figs-ellipsis_3_19__1	Ellipsis	unable to migrate selection, no match found for check in new resources	व्यवस्था-1	
figs-ellipsis_3_3__1	Ellipsis	unable to migrate selection, no match found for check in new resources	सुरु गरेका थियौ-1	
figs-ellipsis_4_12__1	Ellipsis	unable to migrate selection, no match found for check in new resources	म पनि तिमीहरू जस्‍तै भएको छु-1	
figs-ellipsis_4_15__1	Ellipsis	unable to migrate selection, no match found for check in new resources	कि सम्भव भए-1	
figs-ellipsis_4_25__1	Ellipsis	unable to migrate selection, no match found for check in new resources	सङ्केत गर्छिन्,-1	
figs-ellipsis_4_27__1	Ellipsis	unable to migrate selection, no match found for check in new resources	भन्‍दा-1	
figs-ellipsis_4_29__1	Ellipsis	unable to migrate selection, no match found for check in new resources	आत्माअनुसार-1	
figs-ellipsis_5_13__1	Ellipsis	unable to migrate selection, no match found for check in new resources	बरु, प्रेमद्वारा एक अर्काको सेवा गर ।-1	
figs-ellipsis_5_17__1	Ellipsis	unable to migrate selection, no match found for check in new resources	आत्माको इच्‍छा शरीरको विरुद्धमा हुन्‍छ-1	
figs-ellipsis_5_6__1	Ellipsis	unable to migrate selection, no match found for check in new resources	प्रेमद्वारा काम गर्ने विश्‍वासको-1	
figs-ellipsis_6_15__1	Ellipsis	unable to migrate selection, no match found for check in new resources	तर नयाँ सृष्‍टि-1	
figs-exclamations_2_17__1	Exclamations	unable to migrate selection, no match found for check in new resources	यो कहिल्यै नहोस्-1	
figs-exclamations_3_1__1	Exclamations	unable to migrate selection, no match found for check in new resources	हे-1	
figs-exclamations_3_21__1	Exclamations	unable to migrate selection, no match found for check in new resources	कदापि होइन !-1	
figs-exclamations_6_14__1	Exclamations	unable to migrate selection, no match found for check in new resources	मैले अरू कुनै कुरामा कहिल्यै गर्व गर्न नपरोस्-1	
figs-exclusive_1_4__1	Exclusive and Inclusive ‘We’	unable to migrate selection, no match found for check in new resources	हाम्रा-2 हामीलाई-1	
figs-exclusive_2_10__1	Exclusive and Inclusive ‘We’	unable to migrate selection, no match found for check in new resources	हामीले-1 सम्झना निरन्तर गर्नुपर्छ-1	
figs-exclusive_2_15__1	Exclusive and Inclusive ‘We’	unable to migrate selection, no match found for check in new resources	हामी-1	
figs-exclusive_2_16__1	Exclusive and Inclusive ‘We’	unable to migrate selection, no match found for check in new resources	हामीले-1 हामी-2 धर्मी ठहरिन सकौं-1	
figs-exclusive_2_17__1	Exclusive and Inclusive ‘We’	unable to migrate selection, no match found for check in new resources	हामी-1 ठहरियौं भने-1	
figs-exclusive_2_4__1	Exclusive and Inclusive ‘We’	unable to migrate selection, no match found for check in new resources	हाम्रो-1	
figs-exclusive_2_5__1	Exclusive and Inclusive ‘We’	unable to migrate selection, no match found for check in new resources	हामी-1	
figs-exclusive_2_9__1	Exclusive and Inclusive ‘We’	unable to migrate selection, no match found for check in new resources	हामी-1	
figs-exclusive_3_13__1	Exclusive and Inclusive ‘We’	unable to migrate selection, no match found for check in new resources	हाम्रो-1 हामीलाई-1	
figs-exclusive_3_23__1	Exclusive and Inclusive ‘We’	unable to migrate selection, no match found for check in new resources	हामी-1 कैदमा थियौँ-1	
figs-exclusive_3_24__1	Exclusive and Inclusive ‘We’	unable to migrate selection, no match found for check in new resources	हाम्रो-1	
figs-exclusive_3_24__1	Exclusive and Inclusive ‘We’	unable to migrate selection, no match found for check in new resources	हामी वि-1 धर्मी ठहरिन सकौँ-1	
figs-exclusive_3_25__1	Exclusive and Inclusive ‘We’	unable to migrate selection, no match found for check in new resources	हामी-1	
figs-exclusive_4_26__1	Exclusive and Inclusive ‘We’	unable to migrate selection, no match found for check in new resources	हाम्रो-1	
figs-exclusive_4_31__1	Exclusive and Inclusive ‘We’	unable to migrate selection, no match found for check in new resources	हामी-1	
figs-exclusive_4_5__1	Exclusive and Inclusive ‘We’	unable to migrate selection, no match found for check in new resources	हामी-1 स्वीकारिऔँ।-1	
figs-exclusive_5_1__1	Exclusive and Inclusive ‘We’	unable to migrate selection, no match found for check in new resources	हामीलाई-1	
figs-exclusive_5_5__1	Exclusive and Inclusive ‘We’	unable to migrate selection, no match found for check in new resources	हामी-1	
figs-exclusive_6_10__1	Exclusive and Inclusive ‘We’	unable to migrate selection, no match found for check in new resources	हामीले-1 पाउन साथ-1 गर्नुपर्छ-1	
figs-exclusive_6_9__1	Exclusive and Inclusive ‘We’	unable to migrate selection, no match found for check in new resources	हामी-1 निरुत्साहित बन्नु पर्दैन-1 हामीले-1 कटनी गर्नेछौँ-1	
figs-exmetaphor_6_8__1	Biblical Imagery — Extended Metaphors	unable to migrate selection, no match found for check in new resources	आफ्नै शरीरको लागि छर्छ,-1 आत्मामा छर्छ-1	
figs-explicit_1_10__1	Assumed Knowledge and Implicit Information	unable to migrate selection, no match found for check in new resources	किनकि-1	
figs-explicit_1_16__1	Assumed Knowledge and Implicit Information	unable to migrate selection, no match found for check in new resources	उहाँको पुत्रलाई ममा प्रकट गर्नको लागि-1	
figs-explicit_1_6__1	Assumed Knowledge and Implicit Information	unable to migrate selection, no match found for check in new resources	ख्रीष्टको अनुग्रहमा-1	
figs-explicit_2_10__1	Assumed Knowledge and Implicit Information	unable to migrate selection, no match found for check in new resources	हामीले गरिबहरूको सम्झना निरन्तर गर्नुपर्छ-1	
figs-explicit_2_11__1	Assumed Knowledge and Implicit Information	unable to migrate selection, no match found for check in new resources	उनी दोषी ठहरिए-1	
figs-explicit_2_13__1	Assumed Knowledge and Implicit Information	unable to migrate selection, no match found for check in new resources	बाँकी यहूदीहरू-1	
figs-explicit_2_13__1	Assumed Knowledge and Implicit Information	unable to migrate selection, no match found for check in new resources	तिनीहरूको कपटले भड्किए-1	
figs-explicit_2_15__1	Assumed Knowledge and Implicit Information	unable to migrate selection, no match found for check in new resources	अन्यजातिहरू देखि नै पापीहरू-1	
figs-explicit_2_17__1	Assumed Knowledge and Implicit Information	unable to migrate selection, no match found for check in new resources	ख्रीष्टमा धर्मी ठहरिन खोज्दा-1	
figs-explicit_2_19__1	Assumed Knowledge and Implicit Information	unable to migrate selection, no match found for check in new resources	म परमेश्वरमा बाँच्‍न सकूँ ।-1	
figs-explicit_2_20__1	Assumed Knowledge and Implicit Information	unable to migrate selection, no match found for check in new resources	म परमेश्‍वरका पुत्रमा विश्‍वास गरेर जिउँछु-1	
figs-explicit_2_20__1	Assumed Knowledge and Implicit Information	unable to migrate selection, no match found for check in new resources	जसले मलाई प्रेम गर्नुभयो-1	
figs-explicit_2_20__1	Assumed Knowledge and Implicit Information	unable to migrate selection, no match found for check in new resources	आफैलाई-1 दिनुभयो-1	
figs-explicit_2_21__1	Assumed Knowledge and Implicit Information	unable to migrate selection, no match found for check in new resources	यदि धार्मिकता व्यवस्थाद्वारा आउँदछ भने-1	
figs-explicit_2_2__1	Assumed Knowledge and Implicit Information	unable to migrate selection, no match found for check in new resources	तिनीहरूका सामु-1 राखें-1	
figs-explicit_2_2__1	Assumed Knowledge and Implicit Information	unable to migrate selection, no match found for check in new resources	ताकि मैले जो दौड दौड़े र दौड़ीरहन्छु त्यो व्यर्थ नहोस,-1	
figs-explicit_2_4__1	Assumed Knowledge and Implicit Information	unable to migrate selection, no match found for check in new resources	तर-1 कारणले यो भएको थियो-1	
figs-explicit_2_4__1	Assumed Knowledge and Implicit Information	unable to migrate selection, no match found for check in new resources	बीच ल्याएको गोप्यताको-1	
figs-explicit_2_4__1	Assumed Knowledge and Implicit Information	unable to migrate selection, no match found for check in new resources	झुटा भाइहरू-1	
figs-explicit_2_5__1	Assumed Knowledge and Implicit Information	unable to migrate selection, no match found for check in new resources	हामी तिनीहरूका कुरामा-1 समर्पित भएनौँ-1	
figs-explicit_2_6__1	Assumed Knowledge and Implicit Information	unable to migrate selection, no match found for check in new resources	केहि जस्तो देखिनेहरू-1	
figs-explicit_2_6__1	Assumed Knowledge and Implicit Information	unable to migrate selection, no match found for check in new resources	कस्तो प्रकारका-1	
figs-explicit_2_6__1	Assumed Knowledge and Implicit Information	unable to migrate selection, no match found for check in new resources	तिनीहरू पहिले कस्तो प्रकारका थिए मलाई केही फरक पर्दैन-1	
figs-explicit_2_7__1	Assumed Knowledge and Implicit Information	unable to migrate selection, no match found for check in new resources	देखियो-1	
figs-explicit_2_8__1	Assumed Knowledge and Implicit Information	unable to migrate selection, no match found for check in new resources	हुनेले-1	
figs-explicit_3_10__1	Assumed Knowledge and Implicit Information	unable to migrate selection, no match found for check in new resources	जति व्यवस्था अनुसारका कामहरू-1	
figs-explicit_3_10__1	Assumed Knowledge and Implicit Information	unable to migrate selection, no match found for check in new resources	श्रापित हुन्‍छन्-1	
figs-explicit_3_10__1	Assumed Knowledge and Implicit Information	unable to migrate selection, no match found for check in new resources	यसरी लेखिएको छ-1	
figs-explicit_3_11__1	Assumed Knowledge and Implicit Information	unable to migrate selection, no match found for check in new resources	धर्मी विश्वासद्वारा जिउनेछ-1	
figs-explicit_3_11__1	Assumed Knowledge and Implicit Information	unable to migrate selection, no match found for check in new resources	विश्वासद्वारा-1	
figs-explicit_3_12__1	Assumed Knowledge and Implicit Information	unable to migrate selection, no match found for check in new resources	व्यवस्था विश्‍वासबाट होइन,-1	
figs-explicit_3_12__1	Assumed Knowledge and Implicit Information	unable to migrate selection, no match found for check in new resources	कुराहरू-1	
figs-explicit_3_12__1	Assumed Knowledge and Implicit Information	unable to migrate selection, no match found for check in new resources	यसमा जिउनेछ ।”-1	
figs-explicit_3_13__1	Assumed Knowledge and Implicit Information	unable to migrate selection, no match found for check in new resources	किनकि यस्तो लेखिएको छ-1	
figs-explicit_3_13__1	Assumed Knowledge and Implicit Information	unable to migrate selection, no match found for check in new resources	काठमा-1	
figs-explicit_3_14__1	Assumed Knowledge and Implicit Information	unable to migrate selection, no match found for check in new resources	ख्रीष्ट येशूमा-1	
figs-explicit_3_14__1	Assumed Knowledge and Implicit Information	unable to migrate selection, no match found for check in new resources	विश्वासद्वारा-1	
figs-explicit_3_15__1	Assumed Knowledge and Implicit Information	unable to migrate selection, no match found for check in new resources	मानवीय-1	
figs-explicit_3_16__1	Assumed Knowledge and Implicit Information	unable to migrate selection, no match found for check in new resources	उहाँले-1 भन्‍नुहुदैन-1	
figs-explicit_3_18__1	Assumed Knowledge and Implicit Information	unable to migrate selection, no match found for check in new resources	अनुग्रही भई-1 दिनुभयो।-1	
figs-explicit_3_19__1	Assumed Knowledge and Implicit Information	unable to migrate selection, no match found for check in new resources	स्वर्गदूतहरू मार्फत लागु गरिएको थियो-1	
figs-explicit_3_19__1	Assumed Knowledge and Implicit Information	unable to migrate selection, no match found for check in new resources	सन्‍तान नआउन्जेलसम्म-1	
figs-explicit_3_19__1	Assumed Knowledge and Implicit Information	unable to migrate selection, no match found for check in new resources	एक मध्‍यस्तकर्ताको-1	
figs-explicit_3_20__1	Assumed Knowledge and Implicit Information	unable to migrate selection, no match found for check in new resources	एक व्यक्ति-1	
figs-explicit_3_20__1	Assumed Knowledge and Implicit Information	unable to migrate selection, no match found for check in new resources	परमेश्‍वर एक हुनुहुन्छ।-1	
figs-explicit_3_20__2	Assumed Knowledge and Implicit Information	unable to migrate selection, no match found for check in new resources	तर-1	
figs-explicit_3_21__1	Assumed Knowledge and Implicit Information	unable to migrate selection, no match found for check in new resources	प्रतिज्ञाहरू-1	
figs-explicit_3_21__1	Assumed Knowledge and Implicit Information	unable to migrate selection, no match found for check in new resources	जीवन दिन-1	
figs-explicit_3_22__1	Assumed Knowledge and Implicit Information	unable to migrate selection, no match found for check in new resources	सबै कुरा-1	
figs-explicit_3_22__1	Assumed Knowledge and Implicit Information	unable to migrate selection, no match found for check in new resources	पापको अधीनमा-1	
figs-explicit_3_22__1	Assumed Knowledge and Implicit Information	unable to migrate selection, no match found for check in new resources	प्रतिज्ञा-1	
figs-explicit_3_23__1	Assumed Knowledge and Implicit Information	unable to migrate selection, no match found for check in new resources	विश्‍वास आउनु अघि-1	
figs-explicit_3_23__1	Assumed Knowledge and Implicit Information	unable to migrate selection, no match found for check in new resources	मुनि-1	
figs-explicit_3_23__1	Assumed Knowledge and Implicit Information	unable to migrate selection, no match found for check in new resources	विश्‍वास-1	
figs-explicit_3_24__1	Assumed Knowledge and Implicit Information	unable to migrate selection, no match found for check in new resources	द्वारा-1	
figs-explicit_3_24__1	Assumed Knowledge and Implicit Information	unable to migrate selection, no match found for check in new resources	विश्‍वास-1	
figs-explicit_3_25__1	Assumed Knowledge and Implicit Information	unable to migrate selection, no match found for check in new resources	विश्‍वास-1	
figs-explicit_3_25__1	Assumed Knowledge and Implicit Information	unable to migrate selection, no match found for check in new resources	अधीनमा-1	
figs-explicit_3_26__1	Assumed Knowledge and Implicit Information	unable to migrate selection, no match found for check in new resources	ख्रीष्‍ट येशूमा-1	
figs-explicit_3_27__1	Assumed Knowledge and Implicit Information	unable to migrate selection, no match found for check in new resources	तिमीहरूमध्‍ये सबै जतिको-1	
figs-explicit_3_27__1	Assumed Knowledge and Implicit Information	unable to migrate selection, no match found for check in new resources	तिमीहरूमध्‍ये सबै जतिको ख्रीष्‍टमा बप्‍तिस्मा भयो-1	
figs-explicit_3_28__1	Assumed Knowledge and Implicit Information	unable to migrate selection, no match found for check in new resources	अब न त यहूदी छ, न ग्रीक, अब न कमारा छ न फुक्‍का, अब न पुरुष छ न स्‍त्री, किनभने ख्रीष्‍ट येशूमा तिमीहरू सबै एक हौ-1	
figs-explicit_3_28__1	Assumed Knowledge and Implicit Information	unable to migrate selection, no match found for check in new resources	ग्रीक-1	
figs-explicit_3_28__1	Assumed Knowledge and Implicit Information	unable to migrate selection, no match found for check in new resources	फुक्‍का-1	
figs-explicit_3_28__1	Assumed Knowledge and Implicit Information	unable to migrate selection, no match found for check in new resources	एक-1	
figs-explicit_3_29__1	Assumed Knowledge and Implicit Information	unable to migrate selection, no match found for check in new resources	प्रतिज्ञा अनुसार उत्तराधिकारी हौ।-1	
figs-explicit_3_5__1	Assumed Knowledge and Implicit Information	unable to migrate selection, no match found for check in new resources	जसले-1	
figs-explicit_3_6__1	Assumed Knowledge and Implicit Information	unable to migrate selection, no match found for check in new resources	यो-1 गनियो-1	
figs-explicit_3_7__1	Assumed Knowledge and Implicit Information	unable to migrate selection, no match found for check in new resources	विश्‍वास गर्नेहरू-1	
figs-explicit_3_8__1	Assumed Knowledge and Implicit Information	unable to migrate selection, no match found for check in new resources	विश्‍वासद्वारा-1	
figs-explicit_4_10__1	Assumed Knowledge and Implicit Information	unable to migrate selection, no match found for check in new resources	तिमीहरूले-1 मान्‍दछौ-1	
figs-explicit_4_11__1	Assumed Knowledge and Implicit Information	unable to migrate selection, no match found for check in new resources	म-1 डराउँछु-1	
figs-explicit_4_11__1	Assumed Knowledge and Implicit Information	unable to migrate selection, no match found for check in new resources	मैले-1 परिश्रम गरेको छु।-1	
figs-explicit_4_12__1	Assumed Knowledge and Implicit Information	unable to migrate selection, no match found for check in new resources	म जस्‍तै होओ, किनकि म पनि तिमीहरू जस्‍तै भएको छु-1	
figs-explicit_4_14__1	Assumed Knowledge and Implicit Information	unable to migrate selection, no match found for check in new resources	परमेश्‍वरका स्वर्गदूतझै,-1	
figs-explicit_4_14__1	Assumed Knowledge and Implicit Information	unable to migrate selection, no match found for check in new resources	ख्रीष्‍ट येशू झैँ-1	
figs-explicit_4_17__1	Assumed Knowledge and Implicit Information	unable to migrate selection, no match found for check in new resources	तिनीहरू-1 डाही छन्,-1 तिनीहरूले-1 चाहन्‍छन्-1	
figs-explicit_4_17__1	Assumed Knowledge and Implicit Information	unable to migrate selection, no match found for check in new resources	तिमीहरूलाई अलग गर्न-1	
figs-explicit_4_18__1	Assumed Knowledge and Implicit Information	unable to migrate selection, no match found for check in new resources	असल-2	
figs-explicit_4_20__1	Assumed Knowledge and Implicit Information	unable to migrate selection, no match found for check in new resources	मेरो बोलीलाई परिवर्तन गर्न-1	
figs-explicit_4_21__1	Assumed Knowledge and Implicit Information	unable to migrate selection, no match found for check in new resources	अधीनमा-1	
figs-explicit_4_22__1	Assumed Knowledge and Implicit Information	unable to migrate selection, no match found for check in new resources	लेखिएको छ-1	
figs-explicit_4_23__1	Assumed Knowledge and Implicit Information	unable to migrate selection, no match found for check in new resources	शरीरद्वारा-1	
figs-explicit_4_23__1	Assumed Knowledge and Implicit Information	unable to migrate selection, no match found for check in new resources	प्रतिज्ञाद्वारा-1	
figs-explicit_4_24__1	Assumed Knowledge and Implicit Information	unable to migrate selection, no match found for check in new resources	यी कुराहरू-1	
figs-explicit_4_24__1	Assumed Knowledge and Implicit Information	unable to migrate selection, no match found for check in new resources	तिनीहरू-1	
figs-explicit_4_25__1	Assumed Knowledge and Implicit Information	unable to migrate selection, no match found for check in new resources	हागारचाहिँ-1 सीनै पर्वत हुन्-1	
figs-explicit_4_26__1	Assumed Knowledge and Implicit Information	unable to migrate selection, no match found for check in new resources	स्वतन्त्र-1	
figs-explicit_4_27__1	Assumed Knowledge and Implicit Information	unable to migrate selection, no match found for check in new resources	यस्तो लेखिएको छ-1	
figs-explicit_4_27__1	Assumed Knowledge and Implicit Information	unable to migrate selection, no match found for check in new resources	ए बाँझी स्‍त्री-1 तिमी बालक जन्‍माउने पिडा नभोगेकी-1	
figs-explicit_4_29__1	Assumed Knowledge and Implicit Information	unable to migrate selection, no match found for check in new resources	व्यक्तिले-1	
figs-explicit_4_29__1	Assumed Knowledge and Implicit Information	unable to migrate selection, no match found for check in new resources	व्यक्तिलाई-1	
figs-explicit_4_29__1	Assumed Knowledge and Implicit Information	unable to migrate selection, no match found for check in new resources	आत्माअनुसार-1	
figs-explicit_4_2__1	Assumed Knowledge and Implicit Information	unable to migrate selection, no match found for check in new resources	ऊ-1	
figs-explicit_4_2__1	Assumed Knowledge and Implicit Information	unable to migrate selection, no match found for check in new resources	मुनि-1	
figs-explicit_4_2__1	Assumed Knowledge and Implicit Information	unable to migrate selection, no match found for check in new resources	अभिभावकहरू र संरक्षकहरूको-1	
figs-explicit_4_30__1	Assumed Knowledge and Implicit Information	unable to migrate selection, no match found for check in new resources	निकालिदेओ-1	
figs-explicit_4_3__1	Assumed Knowledge and Implicit Information	unable to migrate selection, no match found for check in new resources	मा-1	
figs-explicit_4_3__1	Assumed Knowledge and Implicit Information	unable to migrate selection, no match found for check in new resources	यस जगत्‌का आधारभूत सिद्धान्‍तहरूको-1	
figs-explicit_4_4__1	Assumed Knowledge and Implicit Information	unable to migrate selection, no match found for check in new resources	समयको पूर्णता-1	
figs-explicit_4_4__1	Assumed Knowledge and Implicit Information	unable to migrate selection, no match found for check in new resources	व्यवस्थाअनुसार जन्मिएर-1	
figs-explicit_4_4__1	Assumed Knowledge and Implicit Information	unable to migrate selection, no match found for check in new resources	व्यवस्थाअनुसार-1	
figs-explicit_4_5__1	Assumed Knowledge and Implicit Information	unable to migrate selection, no match found for check in new resources	मुनि-1	
figs-explicit_4_6__1	Assumed Knowledge and Implicit Information	unable to migrate selection, no match found for check in new resources	पुकार्दै-1	
figs-explicit_4_7__1	Assumed Knowledge and Implicit Information	unable to migrate selection, no match found for check in new resources	एक उत्तराधिकारी-1	
figs-explicit_4_8__1	Assumed Knowledge and Implicit Information	unable to migrate selection, no match found for check in new resources	परमेश्‍वरलाई चिन्‍दै-1	
figs-explicit_4_8__1	Assumed Knowledge and Implicit Information	unable to migrate selection, no match found for check in new resources	तिनीहरूका दास थियौ जो स्वभावैले ईश्‍वरहरू होइनन् ।-1	
figs-explicit_4_9__1	Assumed Knowledge and Implicit Information	unable to migrate selection, no match found for check in new resources	चिन्‍दछौ-1 चिनिएका छौ-1	
figs-explicit_4_9__1	Assumed Knowledge and Implicit Information	unable to migrate selection, no match found for check in new resources	किन तिमीहरू-1 फर्किरहेका छौ-1	
figs-explicit_4_9__1	Assumed Knowledge and Implicit Information	unable to migrate selection, no match found for check in new resources	कमजोर र मूल्यहीन आधारभूत सिद्धान्‍तहरू-1	
figs-explicit_5_10__1	Assumed Knowledge and Implicit Information	unable to migrate selection, no match found for check in new resources	तिमीहरूले अर्को तरिकाले विचार गर्दैनौ-1	
figs-explicit_5_11__1	Assumed Knowledge and Implicit Information	unable to migrate selection, no match found for check in new resources	यसो हो भनेता क्रुसको बाधा नष्‍ट हुने थियो ।-1	
figs-explicit_5_13__1	Assumed Knowledge and Implicit Information	unable to migrate selection, no match found for check in new resources	स्वतन्‍त्रता-1 स्वतन्त्र-1	
figs-explicit_5_13__1	Assumed Knowledge and Implicit Information	unable to migrate selection, no match found for check in new resources	प्रेमद्वारा-1	
figs-explicit_5_16__1	Assumed Knowledge and Implicit Information	unable to migrate selection, no match found for check in new resources	आत्माद्वारा-1	
figs-explicit_5_17__1	Assumed Knowledge and Implicit Information	unable to migrate selection, no match found for check in new resources	शरीरका अभिलाषाहरू आत्माको विरुद्धमा हुन्‍छन्,-1	
figs-explicit_5_17__1	Assumed Knowledge and Implicit Information	unable to migrate selection, no match found for check in new resources	जो तिमीहरूले इच्छा गर्छौ-1	
figs-explicit_5_22__1	Assumed Knowledge and Implicit Information	unable to migrate selection, no match found for check in new resources	शान्‍ति-1	
figs-explicit_5_24__1	Assumed Knowledge and Implicit Information	unable to migrate selection, no match found for check in new resources	लालसा र दुष्‍ट अभिलाषाहरू-1	
figs-explicit_5_25__1	Assumed Knowledge and Implicit Information	unable to migrate selection, no match found for check in new resources	हामी-1 जिउँछौँ-1	
figs-explicit_5_2__1	Assumed Knowledge and Implicit Information	unable to migrate selection, no match found for check in new resources	ख्रीष्‍टमा तिमीहरूलाई केही फाइदा हुनेछैन-1	
figs-explicit_5_3__1	Assumed Knowledge and Implicit Information	unable to migrate selection, no match found for check in new resources	सबै व्यवस्था पालन गर्न-1	
figs-explicit_5_4__1	Assumed Knowledge and Implicit Information	unable to migrate selection, no match found for check in new resources	जो व्यवस्थाबाट धर्मी ठहराइएका छौ-1	
figs-explicit_5_5__1	Assumed Knowledge and Implicit Information	unable to migrate selection, no match found for check in new resources	आत्माद्वारा-1	
figs-explicit_5_8__1	Assumed Knowledge and Implicit Information	unable to migrate selection, no match found for check in new resources	यो विश्वास-1	
figs-explicit_6_10__1	Assumed Knowledge and Implicit Information	unable to migrate selection, no match found for check in new resources	भलाइ-1	
figs-explicit_6_10__1	Assumed Knowledge and Implicit Information	unable to migrate selection, no match found for check in new resources	विश्वासको-1	
figs-explicit_6_11__1	Assumed Knowledge and Implicit Information	unable to migrate selection, no match found for check in new resources	आफ्नै हातले-1	
figs-explicit_6_12__1	Assumed Knowledge and Implicit Information	unable to migrate selection, no match found for check in new resources	प्रभाव पार्न-1	
figs-explicit_6_16__1	Assumed Knowledge and Implicit Information	unable to migrate selection, no match found for check in new resources	यही स्तरमा-1	
figs-explicit_6_16__1	Assumed Knowledge and Implicit Information	unable to migrate selection, no match found for check in new resources	परमेश्‍वरको-1 इस्राएलमा-1	
figs-explicit_6_17__1	Assumed Knowledge and Implicit Information	unable to migrate selection, no match found for check in new resources	मलाई कसैले दुःख नदेओस्-1	
figs-explicit_6_18__1	Assumed Knowledge and Implicit Information	unable to migrate selection, no match found for check in new resources	तिमीहरूका आत्मामा-1	
figs-explicit_6_1__1	Assumed Knowledge and Implicit Information	unable to migrate selection, no match found for check in new resources	कुनै मानिसले अपराध गरेको फेला परे-1	
figs-explicit_6_1__1	Assumed Knowledge and Implicit Information	unable to migrate selection, no match found for check in new resources	आत्मिक व्यक्‍तिहरूले-1	
figs-explicit_6_1__1	Assumed Knowledge and Implicit Information	unable to migrate selection, no match found for check in new resources	आत्मामा-1	
figs-explicit_6_2__1	Assumed Knowledge and Implicit Information	unable to migrate selection, no match found for check in new resources	ख्रीष्‍टको व्यवस्था-1	
figs-explicit_6_8__1	Assumed Knowledge and Implicit Information	unable to migrate selection, no match found for check in new resources	विनाश-1	
figs-explicit_6_9__1	Assumed Knowledge and Implicit Information	unable to migrate selection, no match found for check in new resources	असल-1	
figs-extrainfo_2_16__1	When to Keep Information Implicit	unable to migrate selection, no match found for check in new resources	कोही मानिस-1 कुनै पनि शरीर-1	
figs-extrainfo_2_2__1	When to Keep Information Implicit	unable to migrate selection, no match found for check in new resources	तिनीहरूका-1	
figs-extrainfo_3_20__1	When to Keep Information Implicit	unable to migrate selection, no match found for check in new resources	यद्यपि, मध्यस्थ एक व्यक्ति होइन-1	
figs-extrainfo_3_21__1	When to Keep Information Implicit	unable to migrate selection, no match found for check in new resources	जीवन दिन-1	
figs-extrainfo_3_4__1	When to Keep Information Implicit	unable to migrate selection, no match found for check in new resources	यदि त्‍यो साँच्‍चै व्यर्थ थियो भने के तिमीहरूले व्यर्थमा यति धेरै कुराहरूको अनुभव गर्‍यौ?-1	
figs-extrainfo_4_13__1	When to Keep Information Implicit	unable to migrate selection, no match found for check in new resources	कि मेरो शारीरिक कमजोरीको कारण मैले तिमीहरूलाई-1 सुसमाचार प्रचार गरेँ-1	
figs-extrainfo_4_14__1	When to Keep Information Implicit	unable to migrate selection, no match found for check in new resources	मेरो शरिरमा तिमीहरूले आफ्नो परीक्षाको-1	
figs-gendernotations_2_16__1	When Masculine Words Include Women	unable to migrate selection, no match found for check in new resources	मानिस-1	
figs-gendernotations_2_6__1	When Masculine Words Include Women	unable to migrate selection, no match found for check in new resources	मानिसको-1	
figs-gendernotations_3_15__1	When Masculine Words Include Women	unable to migrate selection, no match found for check in new resources	मानवीय-1	
figs-gendernotations_3_15__1	When Masculine Words Include Women	unable to migrate selection, no match found for check in new resources	मानिसले-1	
figs-gendernotations_3_26__1	When Masculine Words Include Women	unable to migrate selection, no match found for check in new resources	पुत्रहरू-1	
figs-gendernotations_3_7__1	When Masculine Words Include Women	unable to migrate selection, no match found for check in new resources	सन्‍तानहरु-1	
figs-gendernotations_4_12__1	When Masculine Words Include Women	unable to migrate selection, no match found for check in new resources	भाइहरू हो-1	
figs-gendernotations_4_28__1	When Masculine Words Include Women	unable to migrate selection, no match found for check in new resources	भाइहरू हो-1	
figs-gendernotations_4_31__1	When Masculine Words Include Women	unable to migrate selection, no match found for check in new resources	भाइहरू हो-1	
figs-gendernotations_4_5__1	When Masculine Words Include Women	unable to migrate selection, no match found for check in new resources	धर्मपुत्रको रूपमा-1	
figs-gendernotations_4_6__1	When Masculine Words Include Women	unable to migrate selection, no match found for check in new resources	पुत्रहरू-1	
figs-gendernotations_4_7__1	When Masculine Words Include Women	unable to migrate selection, no match found for check in new resources	पुत्र-1 पुत्र-2	
figs-gendernotations_5_11__1	When Masculine Words Include Women	unable to migrate selection, no match found for check in new resources	भाइ हो-1	
figs-gendernotations_5_13__1	When Masculine Words Include Women	unable to migrate selection, no match found for check in new resources	भाइहरू-1	
figs-gendernotations_6_18__1	When Masculine Words Include Women	unable to migrate selection, no match found for check in new resources	भाइहरू हो-1	
figs-gendernotations_6_1__1	When Masculine Words Include Women	unable to migrate selection, no match found for check in new resources	भाइहरू हो-1	
figs-gendernotations_6_3__1	When Masculine Words Include Women	unable to migrate selection, no match found for check in new resources	ठान्‍दछ-1 त्‍यसले आफैलाई धोका दिन्‍छ-1	
figs-gendernotations_6_4__1	When Masculine Words Include Women	unable to migrate selection, no match found for check in new resources	उसको-1 उसँग-1 आफैमा-1 हुनेछ-1	
figs-go_2_11__1	Go and Come	unable to migrate selection, no match found for check in new resources	आए-1	
figs-go_2_12__1	Go and Come	unable to migrate selection, no match found for check in new resources	आउनु-1 तिनीहरू आए-1	
figs-go_2_1__1	Go and Come	unable to migrate selection, no match found for check in new resources	मैले-1 यरूशलेममा गएँ-1	
figs-go_2_1__1	Go and Come	unable to migrate selection, no match found for check in new resources	मैले-1 गएँ ।-1	
figs-go_2_2__1	Go and Come	unable to migrate selection, no match found for check in new resources	म-1 गएँ-1	
figs-hypo_3_4__1	Hypothetical Situations	unable to migrate selection, no match found for check in new resources	यदि त्‍यो साँच्‍चै व्यर्थ थियो-1	
figs-hypo_4_15__1	Hypothetical Situations	unable to migrate selection, no match found for check in new resources	कि सम्भव भए त तिमीहरूले मलाई आफ्नो आँखा निकालेर दिने थियौ ।-1	
figs-idiom_2_11__1	Idiom	unable to migrate selection, no match found for check in new resources	मैले उनलाई आमने-सामने विरोध गरेँ-1	
figs-idiom_2_5__1	Idiom	unable to migrate selection, no match found for check in new resources	एक घण्टा-1	
figs-idiom_2_6__1	Idiom	unable to migrate selection, no match found for check in new resources	परमेश्वरले मानिसको अनुहार स्वीकार गर्नुहुन्‍न-1	
figs-idiom_3_19__1	Idiom	unable to migrate selection, no match found for check in new resources	एक मध्‍यस्तकर्ताको हातद्वारा-1	
figs-idiom_4_15__1	Idiom	unable to migrate selection, no match found for check in new resources	कि सम्भव भए त तिमीहरूले मलाई आफ्नो आँखा निकालेर दिने थियौ ।-1	
figs-idiom_4_4__1	Idiom	unable to migrate selection, no match found for check in new resources	स्‍त्रीबाट जन्‍म लिनु भएको-1	
figs-idiom_5_6__1	Idiom	unable to migrate selection, no match found for check in new resources	न त खतना न बेखतना,-1 मूल्यको हुन्‍छ।-1	
figs-idiom_6_15__1	Idiom	unable to migrate selection, no match found for check in new resources	न त खतना न बेखतना-1 केही हो।-1	
figs-idiom_6_2__1	Idiom	unable to migrate selection, no match found for check in new resources	तिमीहरूले-1 पुरा गर्नेछौ ।-1	
figs-idiom_6_3__1	Idiom	unable to migrate selection, no match found for check in new resources	केही हुँ भ-1	
figs-idiom_6_3__1	Idiom	unable to migrate selection, no match found for check in new resources	महत्त्वको नहुँदा नहुँदै-1	
figs-litotes_4_12__1	Litotes	unable to migrate selection, no match found for check in new resources	तिमीहरूले मलाई कुनै हानि गरेनौ।-1	
figs-metaphor_2_18__1	Metaphor	unable to migrate selection, no match found for check in new resources	मैले जुन नष्ट गरेको ति चीजहरू पुन: निर्माण गरें भने, म आफैलाई अपराधी साबित गर्दछु ।-1	
figs-metaphor_2_19__1	Metaphor	unable to migrate selection, no match found for check in new resources	व्यवस्थाको लागि मरे-1	
figs-metaphor_2_19__1	Metaphor	unable to migrate selection, no match found for check in new resources	म ख्रीष्टसँग क्रूसमा टाँगिएको छु-1	
figs-metaphor_2_20__1	Metaphor	unable to migrate selection, no match found for check in new resources	अब उप्रान्त जिउने म होइनँ, तर ख्रीष्‍ट ममा जिउनुहुन्‍छ-1	
figs-metaphor_2_2__1	Metaphor	unable to migrate selection, no match found for check in new resources	मैले-2 दौड दौड़े र दौड़ीरहन्छु-1	
figs-metaphor_2_4__1	Metaphor	unable to migrate selection, no match found for check in new resources	झुटा भाइहरू बीच ल्याएको गोप्यताको-1 जो गोप्य रूपमा-1 आएका थिए-1	
figs-metaphor_2_4__1	Metaphor	unable to migrate selection, no match found for check in new resources	ख्रीष्ट येशूमा-1	
figs-metaphor_2_4__1	Metaphor	unable to migrate selection, no match found for check in new resources	ताकि तिनीहरूले हामीलाई दास बनाउनेछन्-1	
figs-metaphor_3_13__1	Metaphor	unable to migrate selection, no match found for check in new resources	छुटकारा दिनुभयो-1	
figs-metaphor_3_16__1	Metaphor	unable to migrate selection, no match found for check in new resources	उनको सन्‍तानलाई-1 सन्‍तानहरूलाई-1 तिम्रो सन्‍तानलाई-1	
figs-metaphor_3_22__1	Metaphor	unable to migrate selection, no match found for check in new resources	पापको अधीनमा रहेका सबै कुरालाई धर्मशास्‍त्रले कैदमा राख्यो-1	
figs-metaphor_3_23__1	Metaphor	unable to migrate selection, no match found for check in new resources	हामी व्यवस्थामुनि बन्दी बनाइयौ,-1 कैदमा थियौँ-1	
figs-metaphor_3_24__1	Metaphor	unable to migrate selection, no match found for check in new resources	व्यवस्था हाम्रो संरक्षक बन्‍यो-1	
figs-metaphor_3_25__1	Metaphor	unable to migrate selection, no match found for check in new resources	संरक्षकको अधीनमा-1	
figs-metaphor_3_26__1	Metaphor	unable to migrate selection, no match found for check in new resources	पुत्रहरू-1	
figs-metaphor_3_27__1	Metaphor	unable to migrate selection, no match found for check in new resources	ख्रीष्‍टमा बप्‍तिस्मा भयो,-1	
figs-metaphor_3_28__1	Metaphor	unable to migrate selection, no match found for check in new resources	ख्रीष्‍ट येशूमा-1	
figs-metaphor_3_29__1	Metaphor	unable to migrate selection, no match found for check in new resources	सन्तान-1	
figs-metaphor_3_9__1	Metaphor	unable to migrate selection, no match found for check in new resources	विश्वासद्धारा तिनीहरू-1	
figs-metaphor_4_24__1	Metaphor	unable to migrate selection, no match found for check in new resources	दासत्वलाई जन्‍मदिदै-1	
figs-metaphor_4_25__1	Metaphor	unable to migrate selection, no match found for check in new resources	किनकि तिनी तिनका छोराछोरीहरूसँगै दासत्वमा छिन्-1	
figs-metaphor_4_26__1	Metaphor	unable to migrate selection, no match found for check in new resources	माथिको यरूशलेम-1	
figs-metaphor_4_26__1	Metaphor	unable to migrate selection, no match found for check in new resources	जो हाम्रो आमा हो-1	
figs-metaphor_4_27__1	Metaphor	unable to migrate selection, no match found for check in new resources	ए बाँझी स्‍त्री, जन्‍म नदिने, आनन्‍द मनाओ । तिमी बालक जन्‍माउने पिडा नभोगेकी, मन खोल र आनन्‍दले कराऊ । किनकि त्यागिएकीको पति भएकाहरूका भन्‍दा पनि धेरै छोराछोरीहरू छन् ।”-1	
figs-metaphor_4_27__1	Metaphor	unable to migrate selection, no match found for check in new resources	त्यागिएकीको पति भएकाहरूका भन्‍दा पनि धेरै छोराछोरीहरू छन्-1	
figs-metaphor_4_28__1	Metaphor	unable to migrate selection, no match found for check in new resources	प्रतिज्ञाका छोराछोरीहरू-1	
figs-metaphor_4_31__1	Metaphor	unable to migrate selection, no match found for check in new resources	छोराछोरीहरू-1	
figs-metaphor_4_31__1	Metaphor	unable to migrate selection, no match found for check in new resources	दासी स्‍त्रीका-1 तर स्वतन्‍त्र स्‍त्रीका हौँ ।-1	
figs-metaphor_4_5__1	Metaphor	unable to migrate selection, no match found for check in new resources	हामी धर्मपुत्रको रूपमा स्वीकारिऔँ।-1	
figs-metaphor_4_5__1	Metaphor	unable to migrate selection, no match found for check in new resources	धर्मपुत्रको रूपमा-1	
figs-metaphor_4_6__1	Metaphor	unable to migrate selection, no match found for check in new resources	पुत्रहरू-1	
figs-metaphor_4_7__1	Metaphor	unable to migrate selection, no match found for check in new resources	दास-1	
figs-metaphor_4_8__1	Metaphor	unable to migrate selection, no match found for check in new resources	तिमीहरू तिनीहरूका दास थियौ जो स्वभावैले ईश्‍वरहरू होइनन् ।-1	
figs-metaphor_5_10__1	Metaphor	unable to migrate selection, no match found for check in new resources	प्रभुमा-1	
figs-metaphor_5_13__1	Metaphor	unable to migrate selection, no match found for check in new resources	शरीरको निम्ति-1	
figs-metaphor_5_14__1	Metaphor	unable to migrate selection, no match found for check in new resources	सारा व्यवस्था एउटै आज्ञामा पुरा भएको छ-1	
figs-metaphor_5_15__1	Metaphor	unable to migrate selection, no match found for check in new resources	यदि तिमीहरूले एक अर्कालाई टोक्‍ने र निल्ने गर्छौ भने-1	
figs-metaphor_5_15__1	Metaphor	unable to migrate selection, no match found for check in new resources	तिमीहरू आफै एक अर्काबाट नष्‍ट हुन नपरोस् ।-1	
figs-metaphor_5_16__1	Metaphor	unable to migrate selection, no match found for check in new resources	शरीरका-1	
figs-metaphor_5_17__1	Metaphor	unable to migrate selection, no match found for check in new resources	शरीर-1 शरीर-2	
figs-metaphor_5_19__1	Metaphor	unable to migrate selection, no match found for check in new resources	शरीरका-1	
figs-metaphor_5_24__1	Metaphor	unable to migrate selection, no match found for check in new resources	शरीर-1	
figs-metaphor_5_2__1	Metaphor	unable to migrate selection, no match found for check in new resources	हेर-1	
figs-metaphor_5_4__1	Metaphor	unable to migrate selection, no match found for check in new resources	तिमीहरू अनुग्रहबाट टाढा गएका छौ-1	
figs-metaphor_5_6__1	Metaphor	unable to migrate selection, no match found for check in new resources	ख्रीष्‍ट येशूमा-1	
figs-metaphor_6_10__1	Metaphor	unable to migrate selection, no match found for check in new resources	विश्वासको घरानाको निम्ति-1	
figs-metaphor_6_14__1	Metaphor	unable to migrate selection, no match found for check in new resources	क्रुस-1	
figs-metaphor_6_14__1	Metaphor	unable to migrate selection, no match found for check in new resources	संसार मेरो लागि क्रुसमा टाँगिएको छ ।-1	
figs-metaphor_6_14__1	Metaphor	unable to migrate selection, no match found for check in new resources	म संसारको लागि-1	
figs-metaphor_6_15__1	Metaphor	unable to migrate selection, no match found for check in new resources	नयाँ सृष्‍टि-1	
figs-metaphor_6_16__1	Metaphor	unable to migrate selection, no match found for check in new resources	जिउँछन्,-1	
figs-metaphor_6_17__1	Metaphor	unable to migrate selection, no match found for check in new resources	म आफ्नो शरीरमा येशूका चिन्हहरू धारण गर्दछु ।-1	
figs-metaphor_6_2__1	Metaphor	unable to migrate selection, no match found for check in new resources	एक अर्काको भार उठाओ-1	
figs-metaphor_6_4__1	Metaphor	unable to migrate selection, no match found for check in new resources	अरू कसैमा-1 आफैमा-1	
figs-metaphor_6_5__1	Metaphor	unable to migrate selection, no match found for check in new resources	आफ्नो भार आफै उठाउनेछ-1	
figs-metaphor_6_8__1	Metaphor	unable to migrate selection, no match found for check in new resources	शरीर-1 शरीर-2	
figs-metaphor_6_9__1	Metaphor	unable to migrate selection, no match found for check in new resources	हामीले-1 कटनी गर्नेछौँ ।-1	
figs-metonymy_2_12__1	Metonymy	unable to migrate selection, no match found for check in new resources	खतना भएका मानिसहरूसँग-1	
figs-metonymy_2_14__1	Metonymy	unable to migrate selection, no match found for check in new resources	तिनीहरू-1 ठीकसँग हिँडिरहेका थिएनन्-1	
figs-metonymy_2_7__1	Metonymy	unable to migrate selection, no match found for check in new resources	खतना नभएकाहरूलाई-1 जस्तो पत्रुसलाई खतनाको थियो-1	
figs-metonymy_2_8__1	Metonymy	unable to migrate selection, no match found for check in new resources	खतनाको लागि-1	
figs-metonymy_2_9__1	Metonymy	unable to migrate selection, no match found for check in new resources	खतना-1	
figs-metonymy_3_13__1	Metonymy	unable to migrate selection, no match found for check in new resources	श्रापित-1	
figs-metonymy_3_22__1	Metonymy	unable to migrate selection, no match found for check in new resources	धर्मशास्‍त्र-1	
figs-metonymy_3_22__1	Metonymy	unable to migrate selection, no match found for check in new resources	धर्मशास्‍त्रले-1	
figs-metonymy_3_27__1	Metonymy	unable to migrate selection, no match found for check in new resources	जतिको ख्रीष्‍टमा बप्‍तिस्मा भयो, तिमीहरू आफैले ख्रीष्‍टलाई धारण गरेका छौ-1	
figs-metonymy_3_8__1	Metonymy	unable to migrate selection, no match found for check in new resources	सबै जातिहरू-1	
figs-metonymy_4_10__1	Metonymy	unable to migrate selection, no match found for check in new resources	विशेष दिनहरू,र महिनाहरू र ऋतुहरू र वर्षहरू-1	
figs-metonymy_4_25__1	Metonymy	unable to migrate selection, no match found for check in new resources	वर्तमान यरूशलेमको-1 किनकि तिनी-1 दासत्वमा छिन्-1	
figs-metonymy_4_26__1	Metonymy	unable to migrate selection, no match found for check in new resources	माथि-1	
figs-metonymy_5_11__1	Metonymy	unable to migrate selection, no match found for check in new resources	खतनाको प्रचार गर्दछु-1	
figs-metonymy_5_11__1	Metonymy	unable to migrate selection, no match found for check in new resources	क्रुसको-1	
figs-metonymy_6_12__1	Metonymy	unable to migrate selection, no match found for check in new resources	शरीरमा-1	
figs-metonymy_6_13__1	Metonymy	unable to migrate selection, no match found for check in new resources	शरीरमा-1	
figs-metonymy_6_14__1	Metonymy	unable to migrate selection, no match found for check in new resources	हाम्रा प्रभु येशू ख्रीष्‍टको क्रुस-1	
figs-metonymy_6_14__1	Metonymy	unable to migrate selection, no match found for check in new resources	संसारको लागि-1 संसार-2	
figs-metonymy_6_6__1	Metonymy	unable to migrate selection, no match found for check in new resources	वचन-1	
figs-nominaladj_2_10__1	Nominal Adjectives	unable to migrate selection, no match found for check in new resources	गरिब-1	
figs-nominaladj_4_22__1	Nominal Adjectives	unable to migrate selection, no match found for check in new resources	एउटा दासीबाट र अर्को स्वतन्त्र स्त्रीबाट।-1	
figs-nominaladj_4_23__1	Nominal Adjectives	unable to migrate selection, no match found for check in new resources	दासी-1 स्वतन्‍त्र स्‍त्री-1	
figs-nominaladj_4_24__1	Nominal Adjectives	unable to migrate selection, no match found for check in new resources	एक-1	
figs-nominaladj_6_10__1	Nominal Adjectives	unable to migrate selection, no match found for check in new resources	सबै-1	
figs-parallelism_4_27__1	Parallelism	unable to migrate selection, no match found for check in new resources	ए बाँझी स्‍त्री, जन्‍म नदिने, आनन्‍द मनाओ । तिमी बालक जन्‍माउने पिडा नभोगेकी, मन खोल र आनन्‍दले कराऊ ।-1	
figs-personification_3_23__1	Personification	unable to migrate selection, no match found for check in new resources	हामी व्यवस्थामुनि बन्दी बनाइयौ-1 कैदमा थियौँ-1	
figs-personification_3_25__1	Personification	unable to migrate selection, no match found for check in new resources	संरक्षकको अधीनमा-1	
figs-personification_4_25__1	Personification	unable to migrate selection, no match found for check in new resources	तिनी तिनका छोराछोरीहरूसँगै दासत्वमा छिन्-1	
figs-personification_4_26__1	Personification	unable to migrate selection, no match found for check in new resources	हाम्रो आमा-1	
figs-personification_4_30__1	Personification	unable to migrate selection, no match found for check in new resources	धर्मशास्त्रले-1 भन्छ-1	
figs-personification_4_3__1	Personification	unable to migrate selection, no match found for check in new resources	यस जगत्‌का आधारभूत सिद्धान्‍तहरूको बन्धनमा थियौँ-1	
figs-personification_5_13__1	Personification	unable to migrate selection, no match found for check in new resources	शरीरको निम्ति अवसरको रूपमा-1	
figs-personification_5_17__1	Personification	unable to migrate selection, no match found for check in new resources	शरीरका अभिलाषाहरू-1	
figs-personification_5_18__1	Personification	unable to migrate selection, no match found for check in new resources	तिमीहरू व्यवस्थाको अधीनमा हुँदैनौ ।-1	
figs-possession_2_16__-1	Possession	unable to migrate selection, no match found for check in new resources	व्यवस्थाका कामहरू-1	
figs-possession_2_5__1	Possession	unable to migrate selection, no match found for check in new resources	सुसमाचारको सत्यता-1	
figs-possession_3_10__1	Possession	unable to migrate selection, no match found for check in new resources	व्यवस्था अनुसारका कामहरू-1	
figs-possession_3_14__1	Possession	unable to migrate selection, no match found for check in new resources	अब्राहामको आशिष्-1	
figs-possession_3_14__1	Possession	unable to migrate selection, no match found for check in new resources	पवित्र आत्माको प्रतिज्ञा-1	
figs-possession_3_2__1	Possession	unable to migrate selection, no match found for check in new resources	व्यवस्था अनुसारका कामहरू-1	
figs-possession_3_2__1	Possession	unable to migrate selection, no match found for check in new resources	सुनेका कुरामा विश्‍वास गरेर-1	
figs-possession_3_5__1	Possession	unable to migrate selection, no match found for check in new resources	विश्वास गरेर सुनेका कारणले ?-1	
figs-possession_3_5__1	Possession	unable to migrate selection, no match found for check in new resources	त्यो व्यवस्थाको कामद्वारा हो-1	
figs-possession_4_28__1	Possession	unable to migrate selection, no match found for check in new resources	प्रतिज्ञाका छोराछोरीहरू-1	
figs-possession_5_11__1	Possession	unable to migrate selection, no match found for check in new resources	क्रुसको बाधा-1	
figs-possession_5_1__1	Possession	unable to migrate selection, no match found for check in new resources	दासत्वको जुवा-1	
figs-possession_5_22__1	Possession	unable to migrate selection, no match found for check in new resources	पवित्र आत्माका फलचाहिँ-1	
figs-possession_5_5__1	Possession	unable to migrate selection, no match found for check in new resources	धार्मिकताको आशा-1	
figs-possession_6_17__1	Possession	unable to migrate selection, no match found for check in new resources	येशूका चिन्हहरू-1	
figs-possession_6_1__1	Possession	unable to migrate selection, no match found for check in new resources	नम्रताको आत्मा-1	
figs-rquestion_2_17__1	Rhetorical Question	unable to migrate selection, no match found for check in new resources	के ख्रीष्ट पापको सेवक हुनुहुन्छ-1	
figs-rquestion_3_19__1	Rhetorical Question	unable to migrate selection, no match found for check in new resources	त्‍यसो भए व्यवस्था किन-1	
figs-rquestion_3_1__1	Rhetorical Question	unable to migrate selection, no match found for check in new resources	कसले तिमीहरूलाई दुष्ट नजर लगायो,-1	
figs-rquestion_3_21__1	Rhetorical Question	unable to migrate selection, no match found for check in new resources	के व्यवस्था प्रतिज्ञाहरूको विरुद्धमा छ-1	
figs-rquestion_3_3__1	Rhetorical Question	unable to migrate selection, no match found for check in new resources	के अब केवल शरीरमा सिद्ध हुन तिमीहरूले आत्मामा सुरु गरेका थियौ ?-1	
figs-rquestion_3_4__1	Rhetorical Question	unable to migrate selection, no match found for check in new resources	यदि त्‍यो साँच्‍चै व्यर्थ थियो भने-1	
figs-rquestion_3_5__1	Rhetorical Question	unable to migrate selection, no match found for check in new resources	त्यसकारण, जसले तिमीहरूलाई पवित्र आत्मा दिनुहुन्छ र तिमीहरूका बीचमा आश्चर्यकर्म गर्नुहुन्छ, त्यो व्यवस्थाको कामद्वारा हो कि विश्वास गरेर सुनेका कारणले ?-1	
figs-rquestion_4_15__1	Rhetorical Question	unable to migrate selection, no match found for check in new resources	अब, तिमीहरूको आशिष् कहाँ छ-1	
figs-rquestion_4_16__1	Rhetorical Question	unable to migrate selection, no match found for check in new resources	तिमीहरूसँग सत्‍य बताएर, के म तिमीहरूको शत्रु भएको छु-1	
figs-rquestion_4_30__1	Rhetorical Question	unable to migrate selection, no match found for check in new resources	धर्मशास्त्रले के भन्छ-1	
figs-rquestion_4_9__1	Rhetorical Question	unable to migrate selection, no match found for check in new resources	किन तिमीहरू फेरि कमजोर र मूल्यहीन आधारभूत सिद्धान्‍तहरूतर्फ फर्किरहेका छौ-1	
figs-rquestion_5_11__1	Rhetorical Question	unable to migrate selection, no match found for check in new resources	अझै पनि म किन सताइएको छु-1	
figs-rquestion_5_7__1	Rhetorical Question	unable to migrate selection, no match found for check in new resources	सत्‍यताद्धारा उत्प्रेरित नहुन कसले तिमीहरूलाई रोक्यो ?-1	
figs-synecdoche_2_20__1	Synecdoche	unable to migrate selection, no match found for check in new resources	न जीवन म अहिले शरीरमा जिउँछु, म-1 विश्‍वास गरेर जिउँछु-1	
figs-synecdoche_2_20__1	Synecdoche	unable to migrate selection, no match found for check in new resources	जुन जीवन म अहिले शरीरमा जिउँछु,-1	
figs-synecdoche_4_13__1	Synecdoche	unable to migrate selection, no match found for check in new resources	शारीरिक-1	
figs-synecdoche_4_14__1	Synecdoche	unable to migrate selection, no match found for check in new resources	शरिरमा-1	
figs-synecdoche_4_19__1	Synecdoche	unable to migrate selection, no match found for check in new resources	तिमीहरूभित्र ख्रीष्‍ट-1 बनिनुभएसम्म-1	
figs-synecdoche_4_25__1	Synecdoche	unable to migrate selection, no match found for check in new resources	हागारचाहिँ अरबमा सीनै पर्वत हुन्-1	
figs-yousingular_2_14__1	Forms of ‘You’ — Singular	unable to migrate selection, no match found for check in new resources	तपाईं-1 तपाईं-2 बाध्य पार्नुहुन्छ-1	
figs-yousingular_3_29__1	Forms of ‘You’ — Singular	unable to migrate selection, no match found for check in new resources	तिमीहरू-1 तिमीहरू-2	
figs-yousingular_4_10__1	Forms of ‘You’ — Singular	unable to migrate selection, no match found for check in new resources	तिमीहरूले-1 मान्‍दछौ-1	
figs-yousingular_4_11__1	Forms of ‘You’ — Singular	unable to migrate selection, no match found for check in new resources	तिमीहरूका लागि-1 तिमीहरू-2	
figs-yousingular_4_21__1	Forms of ‘You’ — Singular	unable to migrate selection, no match found for check in new resources	तिमीहरू-1	
figs-yousingular_4_28__1	Forms of ‘You’ — Singular	unable to migrate selection, no match found for check in new resources	तिमीहरू-1	
grammar-collectivenouns_2_16__1	Collective Nouns	unable to migrate selection, no match found for check in new resources	व्यवस्थाका-1 व्यवस्थाका-2	
grammar-collectivenouns_2_19__1	Collective Nouns	unable to migrate selection, no match found for check in new resources	व्यवस्थाद्वारा-1 व्यवस्थाको लागि-1	
grammar-collectivenouns_2_19__1	Collective Nouns	unable to migrate selection, no match found for check in new resources	व्यवस्था-1 व्यवस्थाको लागि-1	
grammar-collectivenouns_2_21__1	Collective Nouns	unable to migrate selection, no match found for check in new resources	व्यवस्थाद्वारा-1	
grammar-collectivenouns_2_21__1	Collective Nouns	unable to migrate selection, no match found for check in new resources	व्यवस्था-1	
grammar-collectivenouns_3_10__1	Collective Nouns	unable to migrate selection, no match found for check in new resources	व्यवस्था अनुसारका-1	
grammar-collectivenouns_3_10__1	Collective Nouns	unable to migrate selection, no match found for check in new resources	व्यवस्थाका-1	
grammar-collectivenouns_3_11__1	Collective Nouns	unable to migrate selection, no match found for check in new resources	व्यवस्था-1	
grammar-collectivenouns_3_12__1	Collective Nouns	unable to migrate selection, no match found for check in new resources	व्यवस्था-1	
grammar-collectivenouns_3_13__1	Collective Nouns	unable to migrate selection, no match found for check in new resources	व्यवस्थाको-1	
grammar-collectivenouns_3_17__1	Collective Nouns	unable to migrate selection, no match found for check in new resources	व्यवस्था-1	
grammar-collectivenouns_3_18__1	Collective Nouns	unable to migrate selection, no match found for check in new resources	व्यवस्था-1	
grammar-collectivenouns_3_2__1	Collective Nouns	unable to migrate selection, no match found for check in new resources	व्यवस्था-1	
grammar-collectivenouns_3_5__1	Collective Nouns	unable to migrate selection, no match found for check in new resources	व्यवस्थाको-1	
grammar-collectivenouns_5_14__1	Collective Nouns	unable to migrate selection, no match found for check in new resources	व्यवस्था-1	
grammar-collectivenouns_5_18__1	Collective Nouns	unable to migrate selection, no match found for check in new resources	व्यवस्थाको-1	
grammar-collectivenouns_5_3__1	Collective Nouns	unable to migrate selection, no match found for check in new resources	सबै व्यवस्था-1	
grammar-collectivenouns_5_4__1	Collective Nouns	unable to migrate selection, no match found for check in new resources	व्यवस्था-1	
grammar-connect-condition-fact_2_14__1	Connect — Factual Conditions	unable to migrate selection, no match found for check in new resources	यदि तपाईं यहूदी भएर यहूदीजस्तो होइन, अन्यजातिहरू जस्तै जीवन बिताउनुहुन्छ भने-1	
grammar-connect-condition-fact_2_17__1	Connect — Factual Conditions	unable to migrate selection, no match found for check in new resources	यदि,-1	
grammar-connect-condition-fact_4_7__1	Connect — Factual Conditions	unable to migrate selection, no match found for check in new resources	यदि तिमी पुत्र हौ भने-1	
grammar-connect-condition-fact_5_25__1	Connect — Factual Conditions	unable to migrate selection, no match found for check in new resources	यदि-1	
grammar-connect-condition-hypothetical_2_21__1	Connect — Hypothetical Conditions	unable to migrate selection, no match found for check in new resources	किनकि यदि धार्मिकता व्यवस्थाद्वारा आउँदछ भने, ख्रीष्ट व्यर्थमा मर्नुभयो!”-1	
grammar-connect-condition-hypothetical_3_21__1	Connect — Hypothetical Conditions	unable to migrate selection, no match found for check in new resources	यदि जीवन दिन सक्‍ने व्यवस्था दिइएको भए, निश्‍चय नै त्‍-1	
grammar-connect-condition-hypothetical_3_29__1	Connect — Hypothetical Conditions	unable to migrate selection, no match found for check in new resources	यदि-1 भने,-1	
grammar-connect-condition-hypothetical_5_15__1	Connect — Hypothetical Conditions	unable to migrate selection, no match found for check in new resources	यदि तिमीहरूले एक अर्कालाई टोक्‍ने र निल्ने गर्छौ भने, ध्‍यान देओ, तिमीहरू आफै एक अर्काबाट नष्‍ट हुन नपरोस् ।-1	
grammar-connect-exceptions_2_10__1	Connect — Exception Clauses	unable to migrate selection, no match found for check in new resources	यति कि हामीले गरिबहरूको सम्झना निरन्तर गर्नुपर्छ,-1	
grammar-connect-exceptions_2_16__1	Connect — Exception Clauses	unable to migrate selection, no match found for check in new resources	बाहेक-1	
grammar-connect-exceptions_6_14__1	Connect — Exception Clauses	unable to migrate selection, no match found for check in new resources	बाहेक मैले अरू कुनै कुरामा कहिल्यै गर्व गर्न नपरोस्-1	
grammar-connect-logic-contrast_2_11__1	Connect — Contrast Relationship	unable to migrate selection, no match found for check in new resources	तर-1	
grammar-connect-logic-contrast_2_12__1	Connect — Contrast Relationship	unable to migrate selection, no match found for check in new resources	तर-1	
grammar-connect-logic-contrast_2_14__1	Connect — Contrast Relationship	unable to migrate selection, no match found for check in new resources	तर-1	
grammar-connect-logic-contrast_2_16__1	Connect — Contrast Relationship	unable to migrate selection, no match found for check in new resources	तर-1	
grammar-connect-logic-contrast_2_3__1	Connect — Contrast Relationship	unable to migrate selection, no match found for check in new resources	तर-1	
grammar-connect-logic-contrast_2_6__1	Connect — Contrast Relationship	unable to migrate selection, no match found for check in new resources	तर-1	
grammar-connect-logic-contrast_2_7__1	Connect — Contrast Relationship	unable to migrate selection, no match found for check in new resources	तर यसको विपरित,-1	
grammar-connect-logic-contrast_3_12__1	Connect — Contrast Relationship	unable to migrate selection, no match found for check in new resources	तर-1	
grammar-connect-logic-contrast_3_18__1	Connect — Contrast Relationship	unable to migrate selection, no match found for check in new resources	तर-2	
grammar-connect-logic-contrast_3_20__2	Connect — Contrast Relationship	unable to migrate selection, no match found for check in new resources	तर-1	
grammar-connect-logic-contrast_3_22__1	Connect — Contrast Relationship	unable to migrate selection, no match found for check in new resources	तर-1	
grammar-connect-logic-contrast_3_25__1	Connect — Contrast Relationship	unable to migrate selection, no match found for check in new resources	अब-1	
grammar-connect-logic-contrast_4_17__1	Connect — Contrast Relationship	unable to migrate selection, no match found for check in new resources	तर-1	
grammar-connect-logic-contrast_4_23__1	Connect — Contrast Relationship	unable to migrate selection, no match found for check in new resources	तर-1	
grammar-connect-logic-contrast_4_26__1	Connect — Contrast Relationship	unable to migrate selection, no match found for check in new resources	तर-1	
grammar-connect-logic-contrast_4_2__1	Connect — Contrast Relationship	unable to migrate selection, no match found for check in new resources	तर-1	
grammar-connect-logic-contrast_4_31__1	Connect — Contrast Relationship	unable to migrate selection, no match found for check in new resources	तर-1	
grammar-connect-logic-contrast_4_4__1	Connect — Contrast Relationship	unable to migrate selection, no match found for check in new resources	तर-1	
grammar-connect-logic-contrast_4_7__1	Connect — Contrast Relationship	unable to migrate selection, no match found for check in new resources	तर-1	
grammar-connect-logic-contrast_4_8__1	Connect — Contrast Relationship	unable to migrate selection, no match found for check in new resources	तर-1	
grammar-connect-logic-contrast_4_9__1	Connect — Contrast Relationship	unable to migrate selection, no match found for check in new resources	तर-1	
grammar-connect-logic-goal_2_16__1	Connect — Goal (Purpose) Relationship	unable to migrate selection, no match found for check in new resources	ताकि-1	
grammar-connect-logic-goal_2_19__1	Connect — Goal (Purpose) Relationship	unable to migrate selection, no match found for check in new resources	ताकि-1	
grammar-connect-logic-goal_2_4__1	Connect — Goal (Purpose) Relationship	unable to migrate selection, no match found for check in new resources	ताकि-1	
grammar-connect-logic-goal_2_5__1	Connect — Goal (Purpose) Relationship	unable to migrate selection, no match found for check in new resources	ताकि-1	
grammar-connect-logic-goal_2_9__1	Connect — Goal (Purpose) Relationship	unable to migrate selection, no match found for check in new resources	ताकि-1	
grammar-connect-logic-goal_3_14__1	Connect — Goal (Purpose) Relationship	unable to migrate selection, no match found for check in new resources	ताकि-1	
grammar-connect-logic-goal_3_14__2	Connect — Goal (Purpose) Relationship	unable to migrate selection, no match found for check in new resources	ताकि-2	
grammar-connect-logic-goal_3_19__1	Connect — Goal (Purpose) Relationship	unable to migrate selection, no match found for check in new resources	यो अपराधको कारणले थपिएको थियो-1	
grammar-connect-logic-goal_3_22__1	Connect — Goal (Purpose) Relationship	unable to migrate selection, no match found for check in new resources	ताकि-1	
grammar-connect-logic-goal_3_23__1	Connect — Goal (Purpose) Relationship	unable to migrate selection, no match found for check in new resources	विश्‍वासको प्रकाश नआउन्जेलसम्म-1	
grammar-connect-logic-goal_3_24__1	Connect — Goal (Purpose) Relationship	unable to migrate selection, no match found for check in new resources	नआउन्जेलसम्मको लागि-1	
grammar-connect-logic-goal_3_24__1	Connect — Goal (Purpose) Relationship	unable to migrate selection, no match found for check in new resources	ताकि-1	
grammar-connect-logic-goal_4_17__1	Connect — Goal (Purpose) Relationship	unable to migrate selection, no match found for check in new resources	ताकि-1	
grammar-connect-logic-goal_4_5__1	Connect — Goal (Purpose) Relationship	unable to migrate selection, no match found for check in new resources	निम्ति-1	
grammar-connect-logic-goal_4_5__2	Connect — Goal (Purpose) Relationship	unable to migrate selection, no match found for check in new resources	ताकि-1	
grammar-connect-logic-goal_5_1__1	Connect — Goal (Purpose) Relationship	unable to migrate selection, no match found for check in new resources	स्वतन्‍त्रताको निम्ति-1	
grammar-connect-logic-goal_6_12__1	Connect — Goal (Purpose) Relationship	unable to migrate selection, no match found for check in new resources	त्यसपछि-1	
grammar-connect-logic-goal_6_13__1	Connect — Goal (Purpose) Relationship	unable to migrate selection, no match found for check in new resources	ताकि-1	
grammar-connect-logic-result_2_11__1	Connect — Reason-and-Result Relationship	unable to migrate selection, no match found for check in new resources	जब केफास एन्टिओखियामा आए, मैले उनलाई आमने-सामने विरोध गरेँ किनकि उनी दोषी ठहरिए-1	
grammar-connect-logic-result_2_12__1	Connect — Reason-and-Result Relationship	unable to migrate selection, no match found for check in new resources	किनकि-1	
grammar-connect-logic-result_2_13__1	Connect — Reason-and-Result Relationship	unable to migrate selection, no match found for check in new resources	यसकारण-1	
grammar-connect-logic-result_2_16__1	Connect — Reason-and-Result Relationship	unable to migrate selection, no match found for check in new resources	किनकि व्यवस्थाका कामहरूद्वारा कुनै पनि शरीर धर्मी ठहरिनेछैन-1	
grammar-connect-logic-result_3_17__1	Connect — Reason-and-Result Relationship	unable to migrate selection, no match found for check in new resources	रद्द गर्न-1	
grammar-connect-logic-result_3_24__1	Connect — Reason-and-Result Relationship	unable to migrate selection, no match found for check in new resources	त्‍यसकारण-1	
grammar-connect-logic-result_3_28__1	Connect — Reason-and-Result Relationship	unable to migrate selection, no match found for check in new resources	अब न त यहूदी छ, न ग्रीक, अब न कमारा छ न फुक्‍का, अब न पुरुष छ न स्‍त्री, किनभने ख्रीष्‍ट येशूमा तिमीहरू सबै एक हौ ।-1	
grammar-connect-logic-result_4_12__1	Connect — Reason-and-Result Relationship	unable to migrate selection, no match found for check in new resources	म जस्‍तै होओ, किनकि म पनि तिमीहरू जस्‍तै भएको छु-1	
grammar-connect-logic-result_4_13__1	Connect — Reason-and-Result Relationship	unable to migrate selection, no match found for check in new resources	कारण-1	
grammar-connect-logic-result_4_16__1	Connect — Reason-and-Result Relationship	unable to migrate selection, no match found for check in new resources	त्यसो भए,-1	
grammar-connect-logic-result_4_20__1	Connect — Reason-and-Result Relationship	unable to migrate selection, no match found for check in new resources	अब तिमीहरूकहाँ उपस्थिति हुन चाहन्‍छु र मेरो बोलीलाई परिवर्तन गर्न चाहन्‍छु, किनकि म तिमीहरूको विषयमा अन्‍योलमा परेको छु-1	
grammar-connect-logic-result_4_27__1	Connect — Reason-and-Result Relationship	unable to migrate selection, no match found for check in new resources	किनकि-2	
grammar-connect-logic-result_4_6__1	Connect — Reason-and-Result Relationship	unable to migrate selection, no match found for check in new resources	कारण,-1	
grammar-connect-logic-result_4_7__1	Connect — Reason-and-Result Relationship	unable to migrate selection, no match found for check in new resources	यसैकारणले गर्दा,-1	
grammar-connect-logic-result_5_14__1	Connect — Reason-and-Result Relationship	unable to migrate selection, no match found for check in new resources	किनकि-1	
grammar-connect-logic-result_5_17__1	Connect — Reason-and-Result Relationship	unable to migrate selection, no match found for check in new resources	किनकि-1	
grammar-connect-logic-result_5_17__1	Connect — Reason-and-Result Relationship	unable to migrate selection, no match found for check in new resources	यसकारण-1	
grammar-connect-logic-result_5_17__2	Connect — Reason-and-Result Relationship	unable to migrate selection, no match found for check in new resources	किनकि-2	
grammar-connect-logic-result_5_5__1	Connect — Reason-and-Result Relationship	unable to migrate selection, no match found for check in new resources	किनकि-1	
grammar-connect-logic-result_5_6__1	Connect — Reason-and-Result Relationship	unable to migrate selection, no match found for check in new resources	किनकि-1	
grammar-connect-logic-result_5_7__1	Connect — Reason-and-Result Relationship	unable to migrate selection, no match found for check in new resources	सत्‍यताद्धारा उत्प्रेरित नहुन-1	
grammar-connect-logic-result_6_10__1	Connect — Reason-and-Result Relationship	unable to migrate selection, no match found for check in new resources	यसकारण,-1	
grammar-connect-logic-result_6_13__1	Connect — Reason-and-Result Relationship	unable to migrate selection, no match found for check in new resources	किनकि-1	
grammar-connect-logic-result_6_15__1	Connect — Reason-and-Result Relationship	unable to migrate selection, no match found for check in new resources	किनकि-1	
grammar-connect-logic-result_6_17__1	Connect — Reason-and-Result Relationship	unable to migrate selection, no match found for check in new resources	अब उप्रान्‍त मलाई कसैले दुःख नदेओस्, किनकि म आफ्नो शरीरमा येशूका चिन्हहरू धारण गर्दछु ।-1	
grammar-connect-logic-result_6_3__1	Connect — Reason-and-Result Relationship	unable to migrate selection, no match found for check in new resources	किनकि-1	
grammar-connect-logic-result_6_5__1	Connect — Reason-and-Result Relationship	unable to migrate selection, no match found for check in new resources	किनकि-1	
grammar-connect-logic-result_6_7__1	Connect — Reason-and-Result Relationship	unable to migrate selection, no match found for check in new resources	किनकि-1	
grammar-connect-time-background_2_2__1	Connect — Background Information	unable to migrate selection, no match found for check in new resources	अब-1	
grammar-connect-time-background_4_13__1	Connect — Background Information	unable to migrate selection, no match found for check in new resources	तर-1	
grammar-connect-time-sequential_2_1__1	Connect — Sequential Time Relationship	unable to migrate selection, no match found for check in new resources	अनि-1	
grammar-connect-words-phrases_2_17__1	Connecting Words and Phrases	unable to migrate selection, no match found for check in new resources	तर-1	
grammar-connect-words-phrases_2_19__1	Connecting Words and Phrases	unable to migrate selection, no match found for check in new resources	किनकि-1	
grammar-connect-words-phrases_3_11__1	Connecting Words and Phrases	unable to migrate selection, no match found for check in new resources	अब-1	
grammar-connect-words-phrases_3_12__1	Connecting Words and Phrases	unable to migrate selection, no match found for check in new resources	अब-1	
grammar-connect-words-phrases_3_16__1	Connecting Words and Phrases	unable to migrate selection, no match found for check in new resources	अब-1	
grammar-connect-words-phrases_3_27__1	Connecting Words and Phrases	unable to migrate selection, no match found for check in new resources	किनकि-1	
grammar-connect-words-phrases_3_28__1	Connecting Words and Phrases	unable to migrate selection, no match found for check in new resources	किनभने-1	
grammar-connect-words-phrases_3_29__1	Connecting Words and Phrases	unable to migrate selection, no match found for check in new resources	अब-1	
grammar-connect-words-phrases_3_6__1	Connecting Words and Phrases	unable to migrate selection, no match found for check in new resources	जसरी-1	
grammar-connect-words-phrases_4_15__1	Connecting Words and Phrases	unable to migrate selection, no match found for check in new resources	किनकि-1	
grammar-connect-words-phrases_4_23__1	Connecting Words and Phrases	unable to migrate selection, no match found for check in new resources	र-1	
grammar-connect-words-phrases_4_27__1	Connecting Words and Phrases	unable to migrate selection, no match found for check in new resources	किनकि-1	
grammar-connect-words-phrases_4_28__1	Connecting Words and Phrases	unable to migrate selection, no match found for check in new resources	अब-1	
grammar-connect-words-phrases_4_29__1	Connecting Words and Phrases	unable to migrate selection, no match found for check in new resources	तर-1	
grammar-connect-words-phrases_4_29__1	Connecting Words and Phrases	unable to migrate selection, no match found for check in new resources	जसरी-1	
grammar-connect-words-phrases_4_29__1	Connecting Words and Phrases	unable to migrate selection, no match found for check in new resources	पनि यस्तै नै छ-1	
grammar-connect-words-phrases_4_31__1	Connecting Words and Phrases	unable to migrate selection, no match found for check in new resources	त्‍यसकारण-1	
grammar-connect-words-phrases_4_3__1	Connecting Words and Phrases	unable to migrate selection, no match found for check in new resources	त्यसैगरी-1	
grammar-connect-words-phrases_4_6__1	Connecting Words and Phrases	unable to migrate selection, no match found for check in new resources	र-1	
grammar-connect-words-phrases_4_7__1	Connecting Words and Phrases	unable to migrate selection, no match found for check in new resources	परमेश्‍वरको-1	
grammar-connect-words-phrases_5_13__1	Connecting Words and Phrases	unable to migrate selection, no match found for check in new resources	किनकि-1	
translate-blessing_6_16__1	Blessings	unable to migrate selection, no match found for check in new resources	तिनीहरूमा र परमेश्‍वरको इस्राएलमा शान्‍ति र कृपा रहन्छ।-1	
translate-blessing_6_18__1	Blessings	unable to migrate selection, no match found for check in new resources	तिमीहरूका आत्मामा हाम्रा प्रभु येशू ख्रीष्‍टको अनुग्रह रहोस् ।-1	
translate-transliterate_4_6__1	Copy or Borrow Words	unable to migrate selection, no match found for check in new resources	अब्बा, पिता”-1	
translate-unknown_3_24__1	Translate Unknowns	unable to migrate selection, no match found for check in new resources	संरक्षक-1	
translate-unknown_4_24__1	Translate Unknowns	unable to migrate selection, no match found for check in new resources	यी कुराहरूलाई एउटा रूपक दृष्‍टान्‍त झै वर्णन गरिन्छ-1	
translate-unknown_4_2__1	Translate Unknowns	unable to migrate selection, no match found for check in new resources	संरक्षकहरूको-1	
translate-unknown_4_2__1	Translate Unknowns	unable to migrate selection, no match found for check in new resources	संरक्षकहरूको-1	
translate-unknown_5_9__1	Translate Unknowns	unable to migrate selection, no match found for check in new resources	थोरै खमिरले पुरै आटाको डल्लोलाई फुलाउँछ-1	
