Reference	Localized Group	Message	Selections	
figs-abstractnouns_1_2__1	Abstract Nouns	unable to migrate selection, no match found for check in new resources	ତୁମ୍ଭମାନଙ୍କ ପ୍ରତି ଅନୁଗ୍ରହ ଓ ଶାନ୍ତି ପ୍ରଚୁର ହେଉ-1	
figs-abstractnouns_1_5__1	Abstract Nouns	unable to migrate selection, no match found for check in new resources	ଈଶ୍ବରଙ୍କ ଶକ୍ତି ଦ୍ବାରା-1	
figs-abstractnouns_4_19__1	Abstract Nouns	unable to migrate selection, no match found for check in new resources	ଉତ୍ତମ କର୍ମ କରି-1	
figs-activepassive_1_13__1	Active or Passive	unable to migrate selection, no match found for check in new resources	ଯୀଶୁ ଖ୍ରୀଷ୍ଟଙ୍କ ପ୍ରକାଶନରେ-1	
figs-activepassive_1_7__1	Active or Passive	unable to migrate selection, no match found for check in new resources	ଯୀଶୁ ଖ୍ରୀଷ୍ଟଙ୍କ ପ୍ରକାଶିତ ସମୟରେ-1	
figs-activepassive_2_20__1	Active or Passive	unable to migrate selection, no match found for check in new resources	ସତ୍କର୍ମ କରି ଏବଂ ତୁମ୍ଭେମାନେ ଦୁଃଖ ସହ୍ୟ କରିବ-1	
figs-activepassive_2_7__1	Active or Passive	unable to migrate selection, no match found for check in new resources	ଯେଉଁ ପ୍ରସ୍ତର ଯାହା ନିର୍ମାଣକାରୀମାନଙ୍କ ଦ୍ବାରା ଅଗ୍ରାହ୍ୟ ହେଲା-1	
figs-doublet_3_4__1	Doublet	unable to migrate selection, no match found for check in new resources	ହୃଦୟର ଆନ୍ତରିକ ମନୁଷ୍ୟ-1	
figs-euphemism_4_6__1	Euphemism	unable to migrate selection, no match found for check in new resources	ଯେପରି ସେମାନେ ମନୁଷ୍ୟ ଭାବେ ଶରୀରରେ ବିଚାରିତ ହେବେ-1	
figs-explicit_2_12__1	Assumed Knowledge and Implicit Information	unable to migrate selection, no match found for check in new resources	ଅନୁଗ୍ରହର ଦିବସରେ-1	
figs-explicit_2_2__1	Assumed Knowledge and Implicit Information	unable to migrate selection, no match found for check in new resources	ତୁମ୍ଭେମାନେ ପରିତ୍ରାଣ ନିମନ୍ତେ ବୃଦ୍ଧିଲାଭ କରିପାର-1	
figs-explicit_2_6__1	Assumed Knowledge and Implicit Information	unable to migrate selection, no match found for check in new resources	ମନୋନୀତ-1 ବହୁମୂଲ୍ୟ-1 ଏକ କୋଣର ପ୍ରଧାନପ୍ରସ୍ତର-1	
figs-explicit_3_9__1	Assumed Knowledge and Implicit Information	unable to migrate selection, no match found for check in new resources	ଆଶୀର୍ବାଦ କର-1	
figs-idiom_1_13__1	Idiom	unable to migrate selection, no match found for check in new resources	ସମ୍ପୁର୍ଣରୁପେ ସଚେତନ ହୋଇ-1	
figs-idiom_4_7__1	Idiom	unable to migrate selection, no match found for check in new resources	ଯତ୍ନବାନ ହୁଅ-1	
figs-idiom_5_8__1	Idiom	unable to migrate selection, no match found for check in new resources	ସଚେତନ ହୁଅ-1	
figs-metaphor_1_20__1	Metaphor	unable to migrate selection, no match found for check in new resources	ସେ ତୁମ୍ଭମାନଙ୍କ ହିତ ନିମନ୍ତେ-1 ପ୍ରକାଶିତ ହୋଇଅଛନ୍ତି-1	
figs-metaphor_1_4__1	Metaphor	unable to migrate selection, no match found for check in new resources	ଅକ୍ଷୟ ଏବଂ ଅକଳୁଷିତ ଏବଂ ଅକ୍ଷଣୀୟ-1	
figs-metaphor_2_11__1	Metaphor	unable to migrate selection, no match found for check in new resources	ଶାରୀରିକ ଅଭିଳାଷରୁ ପୃଥକ ରହିବା ନିମନ୍ତେ-1	
figs-metaphor_2_11__1	Metaphor	unable to migrate selection, no match found for check in new resources	ତୁମ୍ଭମାନଙ୍କ-2 ଆତ୍ମା ବିରୁଦ୍ଧରେ ଯୁଦ୍ଧ କରେ-1	
figs-metaphor_2_2__1	Metaphor	unable to migrate selection, no match found for check in new resources	ନବଜାତ ଶିଶୁ ତୁଲ୍ୟ-1 ଶୁଦ୍ଧ ଆତ୍ମିକ ଦୁଗ୍ଧ ନିମନ୍ତେ ଲାଳାୟିତ ହୁଅ-1	
figs-metaphor_2_6__1	Metaphor	unable to migrate selection, no match found for check in new resources	ଧର୍ମଶାସ୍ତ୍ରରେ ଏହା ପ୍ରମାଣିତ ହୁଏ-1	
figs-metaphor_3_12__1	Metaphor	unable to migrate selection, no match found for check in new resources	ପ୍ରଭୁଙ୍କ ଦୃଷ୍ଟି ଧାର୍ମିକମାନଙ୍କ ପ୍ରତି-1 ଅଛି-1	
figs-metaphor_3_12__1	Metaphor	unable to migrate selection, no match found for check in new resources	କିନ୍ତୁ ପ୍ରଭୁଙ୍କର ମୂଖ-1 ପ୍ରତିକୁଳ-1 ଅଟେ-1	
figs-metaphor_3_18__1	Metaphor	unable to migrate selection, no match found for check in new resources	ଯେପରି ସେ ଆମ୍ଭମାନଙ୍କୁ ଈଶ୍ବରଙ୍କ ନିକଟକୁ ଆଣି ପାରନ୍ତି-1	
figs-metaphor_3_18__1	Metaphor	unable to migrate selection, no match found for check in new resources	ଶରୀରରେ ମୃତ୍ୟୁଭୋଗ ନିମନ୍ତେ ସଂସ୍ଥାପିତ ହେଲେ-1	
figs-metaphor_3_6__1	Metaphor	unable to migrate selection, no match found for check in new resources	ଯାହାଙ୍କର ତୁମ୍ଭେମାନେ ସନ୍ତାନ ହୋଇଅଛ-1	
figs-metaphor_4_8__1	Metaphor	unable to migrate selection, no match found for check in new resources	ପ୍ରେମ ବହୁଳ ପାପ ଆଚ୍ଛାଦନ କରେ-1	
figs-metaphor_5_10__1	Metaphor	unable to migrate selection, no match found for check in new resources	ତୁମ୍ଭମାନଙ୍କୁ-2 ସବଳ-1 ଏବଂ-1 ସଂସ୍ଥାପିତ କରିବେ-1	
figs-metaphor_5_12__1	Metaphor	unable to migrate selection, no match found for check in new resources	ଏଥିରେ ସୁସ୍ଥିର ରୁହ-1	
figs-metaphor_5_2__1	Metaphor	unable to migrate selection, no match found for check in new resources	ଈଶ୍ବରଙ୍କ ପଲର ପ୍ରତିପାଳନ କର-1	
figs-metonymy_1_24__1	Metonymy	unable to migrate selection, no match found for check in new resources	"ସମସ୍ତ ମର୍ତ୍ତ୍ୟ ତୃଣ ସଦୃଶ-1 ଅଟେ-1 ତୃଣ ଶିଖିଯାଏ-1	
figs-metonymy_2_11__1	Metonymy	unable to migrate selection, no match found for check in new resources	ତୁମ୍ଭମାନଙ୍କ-2 ଆତ୍ମା-1	
figs-metonymy_2_24__1	Metonymy	unable to migrate selection, no match found for check in new resources	ଆମ୍ଭମାନଙ୍କ ପାପସବୁ ଆପଣା ଦେହରେ ବୃକ୍ଷ ଉପରେ ବହନ କଲେ-1	
figs-metonymy_2_5__1	Metonymy	unable to migrate selection, no match found for check in new resources	ଆତ୍ମିକ ବଳୀ ଉତ୍ସର୍ଗ କରିବାକୁ ଏକ ପବିତ୍ର ଯାଜକବର୍ଗ-1	
figs-metonymy_3_10__1	Metonymy	unable to migrate selection, no match found for check in new resources	ମଙ୍ଗଳର ଦିନ-1	
figs-metonymy_3_4__1	Metonymy	unable to migrate selection, no match found for check in new resources	ହୃଦୟର ଆନ୍ତରିକ ମନୁଷ୍ୟ-1	
figs-metonymy_5_1__1	Metonymy	unable to migrate selection, no match found for check in new resources	ମହିମାରେ ଅଂଶୀ ଯାହା ପ୍ରକାଶିତ ହେବାକୁ ଯାଉଅଛି-1	
figs-parallelism_3_10__1	Parallelism	unable to migrate selection, no match found for check in new resources	ମନ୍ଦତାରୁ-1 ତାହାର} ଜିହ୍ଵା ଏବଂ ଛଳବାକ୍ୟରୁ-1 ତାହାର-2 ଓଷ୍ଠାଧର ନିବୃତ୍ତ କରୁ-1	
figs-parallelism_4_14__1	Parallelism	unable to migrate selection, no match found for check in new resources	ଗୌରବମୟ ଓ ଈଶ୍ବରଙ୍କ ଆତ୍ମା-1	
figs-parallelism_4_7__1	Parallelism	unable to migrate selection, no match found for check in new resources	ସୁବୁଦ୍ଧି ସମ୍ପନ୍ନ ହୁଅ-1 ଓ ପ୍ରାର୍ଥନା ନିମନ୍ତେ ଯତ୍ନବାନ ହୁଅ-1	
figs-personification_3_20__1	Personification	unable to migrate selection, no match found for check in new resources	ଯେତେବେଳେ-1 ଈଶ୍ବରଙ୍କ ଧୈର୍ଯ୍ୟ ଅପେକ୍ଷା କରୁଥିଲା-1	
figs-personification_4_8__1	Personification	unable to migrate selection, no match found for check in new resources	କାରଣ ପ୍ରେମ ବହୁଳ ପାପ ଆଚ୍ଛାଦନ କରେ-1	
figs-synecdoche_3_12__1	Synecdoche	unable to migrate selection, no match found for check in new resources	ପ୍ରଭୁଙ୍କ ଦୃଷ୍ଟି ଧାର୍ମିକମାନଙ୍କ ପ୍ରତି-1 ଅଛି-1	
figs-synecdoche_3_12__1	Synecdoche	unable to migrate selection, no match found for check in new resources	ତାହାଙ୍କ କର୍ଣ୍ଣ ସେମାନଙ୍କ ବିନତୀ ପ୍ରତି-1 ଅଛି-2	
grammar-connect-logic-result_3_7__1	Connect — Reason-and-Result Relationship	unable to migrate selection, no match found for check in new resources	ଯେପରି-2	
