Reference	Localized Group	Message	Selections	
figs-abstractnouns_7_12__1	Abstract Nouns	unable to migrate selection, no match found for check in new resources	ఆయన మంచివాడు.-1	
figs-doublenegatives_20_27__1	Double Negatives	unable to migrate selection, no match found for check in new resources	అవిశ్వాసివిగా ఉండ వద్దు, అయితే విశ్వసించు.-1	
figs-explicit_18_36__2	Assumed Knowledge and Implicit Information	unable to migrate selection, no match found for check in new resources	ఈ లోకసంబంధమైనది-1	
figs-explicit_19_42__1	Assumed Knowledge and Implicit Information	unable to migrate selection, no match found for check in new resources	యూదుల సిద్ధపరచు దినము కారణంగా మరియు ఆ సమాధి సమీపములో ఉంది కనుక, వారు యేసును అక్కడ ఉంచారు-1	
figs-explicit_20_15__1	Assumed Knowledge and Implicit Information	unable to migrate selection, no match found for check in new resources	నీవు ఆయనను మోసికొనిపోయిన యెడల-1	
figs-explicit_20_17__1	Assumed Knowledge and Implicit Information	unable to migrate selection, no match found for check in new resources	'నా తండ్రి మరియు మీ తండ్రి, మరియు నా దేవుడు మరియు మీ దేవుడు వద్దకు నేను వెళ్ళు చున్నాను.'"-1	
figs-explicit_20_18__1	Assumed Knowledge and Implicit Information	unable to migrate selection, no match found for check in new resources	మగ్దలేనే మరియ వచ్చింది,-1 సంగతులు-1 శిష్యులతో చెప్పింది.-1	
figs-explicit_20_19__1	Assumed Knowledge and Implicit Information	unable to migrate selection, no match found for check in new resources	యూదుల యొక్క భయము-1	
figs-explicit_20_20__1	Assumed Knowledge and Implicit Information	unable to migrate selection, no match found for check in new resources	ఆయన వారికి {తన} చేతులు మరియు {ఆయన} ప్రక్కను చూపించాడు-1	
figs-explicit_20_27__1	Assumed Knowledge and Implicit Information	unable to migrate selection, no match found for check in new resources	విశ్వసించు.-1	
figs-explicit_20_29__1	Assumed Knowledge and Implicit Information	unable to migrate selection, no match found for check in new resources	నీవు నమ్మావు-1	
figs-explicit_20_29__1	Assumed Knowledge and Implicit Information	unable to migrate selection, no match found for check in new resources	చూడకుండా-1	
figs-explicit_20_2__1	Assumed Knowledge and Implicit Information	unable to migrate selection, no match found for check in new resources	వారు ప్రభువును సమాధి నుండి తీసుకొని వెళ్ళారు,-1	
figs-explicit_20_8__1	Assumed Knowledge and Implicit Information	unable to migrate selection, no match found for check in new resources	అతడు చూసి మరియు నమ్మాడు-1	
figs-explicit_20_9__1	Assumed Knowledge and Implicit Information	unable to migrate selection, no match found for check in new resources	లేఖనమును వారు ఇంకా అర్థం చేసుకోలేదు.-1	
figs-explicit_21_19__1	Assumed Knowledge and Implicit Information	unable to migrate selection, no match found for check in new resources	ఏ విధమైన మరణముతో అతడు దేవుని మహిమపరచునో సూచించాడు.-1	
figs-explicit_21_19__1	Assumed Knowledge and Implicit Information	unable to migrate selection, no match found for check in new resources	"నన్ను వెంబడించుము."-1	
figs-explicit_21_24__1	Assumed Knowledge and Implicit Information	unable to migrate selection, no match found for check in new resources	మనం యెరుగుదుము.-1	
figs-idiom_21_7__1	Idiom	unable to migrate selection, no match found for check in new resources	తన్ను తాను త్రోసి వేసుకొన్నాడు.-1	
figs-metaphor_15_6__1	Metaphor	unable to migrate selection, no match found for check in new resources	వారు వాటిని పోగుచేస్తారు మరియు {వాటిని} అగ్నిలోనికి త్రోసివేస్తారు, మరియు అవి కాలిపోవును.-1	
figs-metonymy_12_28__1	Metonymy	unable to migrate selection, no match found for check in new resources	ఒక స్వరము ఆకాశము నుండి వచ్చింది.-1	
figs-metonymy_12_38__1	Metonymy	unable to migrate selection, no match found for check in new resources	ప్రభువు యొక్క బాహువు-1	
figs-metonymy_17_18__2	Metonymy	unable to migrate selection, no match found for check in new resources	లోకములోనికి-1 లోకములోనికి-2	
figs-metonymy_18_36__2	Metonymy	unable to migrate selection, no match found for check in new resources	ఈ లోకసం-1 ఈ లోకము-2 ఇక్కడ నుండి కాదు.-1	
figs-metonymy_20_31__1	Metonymy	unable to migrate selection, no match found for check in new resources	నామములో మీరు జీవము కలిగియుంటారు.-1	
grammar-connect-logic-goal_1_31__1	Connect — Goal (Purpose) Relationship	unable to migrate selection, no match found for check in new resources	తద్వారా ఆయన ఇశ్రాయేలుకు ప్రత్యక్షమవుతాడు,-1	
grammar-connect-logic-goal_6_52__1	Connect — Goal (Purpose) Relationship	unable to migrate selection, no match found for check in new resources	తినడానికి-1	
grammar-connect-logic-goal_9_39__1	Connect — Goal (Purpose) Relationship	unable to migrate selection, no match found for check in new resources	చూడనివారు చూస్తారు మరియు చూచువారు గ్రుడ్డివారు అవుతారు.-1	
grammar-connect-time-sequential_3_22__1	Connect — Sequential Time Relationship	unable to migrate selection, no match found for check in new resources	ఈ సంగతుల తరువాత,-1	
grammar-connect-time-sequential_5_14__1	Connect — Sequential Time Relationship	unable to migrate selection, no match found for check in new resources	ఈ సంగతుల తరువాత,-1	
grammar-connect-time-sequential_5_1__1	Connect — Sequential Time Relationship	unable to migrate selection, no match found for check in new resources	ఈ సంగతుల తరువాత-1	
grammar-connect-time-sequential_6_1__1	Connect — Sequential Time Relationship	unable to migrate selection, no match found for check in new resources	ఈ సంగతుల తరువాత,-1	
grammar-connect-time-sequential_7_1__1	Connect — Sequential Time Relationship	unable to migrate selection, no match found for check in new resources	మరియు ఈ సంగతుల తరువాత-1	
guidelines-sonofgodprinciples_17_21__1	Translating Son and Father	unable to migrate selection, no match found for check in new resources	వారు కూడా మనలో ఉండాలి అని, తద్వారా నువ్వు నన్ను పంపావు అని లోకం తెలుసుకొంటుంది.-1	
translate-names_19_39__1	How to Translate Names	unable to migrate selection, no match found for check in new resources	మొదట రాత్రివేళ ఆయన వద్దకు వచ్చినవాడు-1	
writing-background_11_5__1	Background Information	unable to migrate selection, no match found for check in new resources	ఇప్పుడు యేసు మార్తను మరియు ఆమె సహోదరిని మరియు లాజరును ప్రేమించెను.)-1	
writing-background_1_24__1	Background Information	unable to migrate selection, no match found for check in new resources	పంపబడిన వారు పరిసయ్యుల నుండి,-1	
writing-background_1_44__1	Background Information	unable to migrate selection, no match found for check in new resources	ఫిలిప్పు బేత్సయిదా నుండి, అంద్రెయ మరియు పేతురు యొక్క నగరము నుండి వచ్చాడు.-1	
writing-background_2_9__1	Background Information	unable to migrate selection, no match found for check in new resources	(అది ఎక్కడ నుండి వచ్చెనో అతనికి తెలియక పోయెను, అయితే - నీళ్లు తీసుకొనివచ్చిన సేవకులకు - తెలిసింది)-1	
writing-background_5_1__1	Background Information	unable to migrate selection, no match found for check in new resources	ఈ సంగతుల తరువాత యూదుల పండుగ ఒకటి వచ్చింది, మరియు యేసు యెరూషలేమునకు వెళ్ళాడు-1	
writing-background_6_59__1	Background Information	unable to migrate selection, no match found for check in new resources	పెర్నహూములో బోధించుచు సమాజమందిరములో ఈ సంగతులు చెప్పాడు.-1	
writing-background_7_2__1	Background Information	unable to migrate selection, no match found for check in new resources	యూదుల యొక్క పండుగ, పర్ణశాలల పండుగ సమీపంగా ఉంది.-1	
writing-pronouns_1_11__1	Pronouns — When to Use Them	unable to migrate selection, no match found for check in new resources	సొంతవారి-1 వచ్చాడు. మ-1	
writing-pronouns_1_12__1	Pronouns — When to Use Them	unable to migrate selection, no match found for check in new resources	ఆయనను-1	
writing-pronouns_1_13__1	Pronouns — When to Use Them	unable to migrate selection, no match found for check in new resources	వీరు-1	
writing-pronouns_1_14__1	Pronouns — When to Use Them	unable to migrate selection, no match found for check in new resources	ఆయన మహిమను-1	
writing-pronouns_1_15__1	Pronouns — When to Use Them	unable to migrate selection, no match found for check in new resources	ఆయనను-1	
writing-pronouns_1_23__1	Pronouns — When to Use Them	unable to migrate selection, no match found for check in new resources	అతడు చెప్పాడు-1	
writing-pronouns_1_28__1	Pronouns — When to Use Them	unable to migrate selection, no match found for check in new resources	ఈ సంగతులు-1	
writing-pronouns_1_31__1	Pronouns — When to Use Them	unable to migrate selection, no match found for check in new resources	దీని కారణంగా-1	
writing-pronouns_1_4__1	Pronouns — When to Use Them	unable to migrate selection, no match found for check in new resources	ఆయనలో-1	
writing-pronouns_1_50__1	Pronouns — When to Use Them	unable to migrate selection, no match found for check in new resources	గొప్ప కార్యములు నువ్వు చూస్తావు-1	
writing-pronouns_1_7__1	Pronouns — When to Use Them	unable to migrate selection, no match found for check in new resources	అతని ద్వారా-1	
writing-pronouns_2_12__1	Pronouns — When to Use Them	unable to migrate selection, no match found for check in new resources	దీని తరువాత-1	
writing-pronouns_2_12__1	Pronouns — When to Use Them	unable to migrate selection, no match found for check in new resources	ఆయన తల్లియు-1	
writing-pronouns_2_18__1	Pronouns — When to Use Them	unable to migrate selection, no match found for check in new resources	ఈ సంగతులు-1	
writing-pronouns_2_23__1	Pronouns — When to Use Them	unable to migrate selection, no match found for check in new resources	ఇప్పుడు ఆయన-1 ఉన్నప్పుడు,-1	
writing-pronouns_3_10__1	Pronouns — When to Use Them	unable to migrate selection, no match found for check in new resources	ఈ సంగతులను-1	
writing-pronouns_3_16__1	Pronouns — When to Use Them	unable to migrate selection, no match found for check in new resources	ఆయనలో-1	
writing-pronouns_3_9__1	Pronouns — When to Use Them	unable to migrate selection, no match found for check in new resources	"ఈ సంగతులు-1	
writing-pronouns_4_19__1	Pronouns — When to Use Them	unable to migrate selection, no match found for check in new resources	ఆయనకు-1	
writing-pronouns_4_30__1	Pronouns — When to Use Them	unable to migrate selection, no match found for check in new resources	ఆయన వద్దకు-1	
writing-pronouns_4_3__1	Pronouns — When to Use Them	unable to migrate selection, no match found for check in new resources	ఆయన-1 విడిచిపెట్టాడు-1	
writing-pronouns_4_43__1	Pronouns — When to Use Them	unable to migrate selection, no match found for check in new resources	బయలుదేరి-1	
writing-pronouns_4_46__1	Pronouns — When to Use Them	unable to migrate selection, no match found for check in new resources	ఆయన తిరిగి వచ్చాడు-1	
writing-pronouns_4_9__1	Pronouns — When to Use Them	unable to migrate selection, no match found for check in new resources	ఆయనకు చెప్పింది, "-1	
writing-pronouns_5_16__1	Pronouns — When to Use Them	unable to migrate selection, no match found for check in new resources	ఈ కారణంగా,-1	
writing-pronouns_5_17__1	Pronouns — When to Use Them	unable to migrate selection, no match found for check in new resources	వారికి ప్రత్యుత్తరమిచ్చాడు-1	
writing-pronouns_5_18__1	Pronouns — When to Use Them	unable to migrate selection, no match found for check in new resources	కారణంగా, కాబట్టి-1	
writing-pronouns_5_20__1	Pronouns — When to Use Them	unable to migrate selection, no match found for check in new resources	గొప్ప క్రియలను ఆయనకు కనుపరచును-1	
writing-pronouns_5_28__1	Pronouns — When to Use Them	unable to migrate selection, no match found for check in new resources	దీనికి ఆశ్చర్యపడకుడి-1	
writing-pronouns_5_34__1	Pronouns — When to Use Them	unable to migrate selection, no match found for check in new resources	నేను ఈ సంగతులు-1	
writing-pronouns_6_59__1	Pronouns — When to Use Them	unable to migrate selection, no match found for check in new resources	ఆయన-1 చెప్పాడు.-1	
writing-pronouns_6_59__1	Pronouns — When to Use Them	unable to migrate selection, no match found for check in new resources	ఈ సంగతులు-1	
writing-pronouns_6_61__1	Pronouns — When to Use Them	unable to migrate selection, no match found for check in new resources	దీనిని గురించి-1 "ఇది-1	
writing-pronouns_6_65__1	Pronouns — When to Use Them	unable to migrate selection, no match found for check in new resources	"దీని కారణంగా, తం-1	
writing-pronouns_6_8__1	Pronouns — When to Use Them	unable to migrate selection, no match found for check in new resources	ఆయన-1 ఆయనకు-1	
writing-pronouns_8_40__1	Pronouns — When to Use Them	unable to migrate selection, no match found for check in new resources	అబ్రాహాము దీనిని చేయ లేదు.-1	
writing-pronouns_9_22__1	Pronouns — When to Use Them	unable to migrate selection, no match found for check in new resources	ఆయన క్రీస్తు అని యెవరైనను ఒప్పుకొనిన-1	
